Archaea;Thaumarchaeota;Nitrososphaeria;Nitrosopumilales;Nitrosopumilaceae;Brassica_napus_(rape)	Archaea;Thaumarchaeota;Nitrososphaeria;Nitrosopumilales;Nitrosopumilaceae
Bacteria;Acidobacteria;Blastocatellia_(Subgroup_4);Blastocatellales;Blastocatellaceae;Blastocatella;Ictalurus_punctatus_(channel_catfish)	Bacteria;Acidobacteria;Blastocatellia_(Subgroup_4);Blastocatellales;Blastocatellaceae;Blastocatella
Bacteria;Actinobacteria;Actinobacteria;Actinomycetales;Actinomycetaceae;Actinomyces;Chlamydia_trachomatis	Bacteria;Actinobacteria;Actinobacteria;Actinomycetales;Actinomycetaceae;Actinomyces
Bacteria;Actinobacteria;Actinobacteria;Actinomycetales;Actinomycetaceae;Actinomyces;Gadus_morhua_(Atlantic_cod)	Bacteria;Actinobacteria;Actinobacteria;Actinomycetales;Actinomycetaceae;Actinomyces
Bacteria;Actinobacteria;Actinobacteria;Bifidobacteriales;Bifidobacteriaceae;Bifidobacterium;Tetragonula_carbonaria	Bacteria;Actinobacteria;Actinobacteria;Bifidobacteriales;Bifidobacteriaceae;Bifidobacterium
Bacteria;Actinobacteria;Actinobacteria;Bifidobacteriales;Bifidobacteriaceae;Gardnerella;Bifidobacterium_sp._DA-40A	Bacteria;Actinobacteria;Actinobacteria;Bifidobacteriales;Bifidobacteriaceae;Gardnerella
Bacteria;Actinobacteria;Actinobacteria;Bifidobacteriales;Bifidobacteriaceae;Gardnerella;Bifidobacterium_sp._DA-40B	Bacteria;Actinobacteria;Actinobacteria;Bifidobacteriales;Bifidobacteriaceae;Gardnerella
Bacteria;Actinobacteria;Actinobacteria;Catenulisporales;Actinospicaceae;Actinospica;Persicaria_minor	Bacteria;Actinobacteria;Actinobacteria;Catenulisporales;Actinospicaceae;Actinospica
Bacteria;Actinobacteria;Actinobacteria;Corynebacteriales;Nocardiaceae;Rhodococcus;Homalodisca_vitripennis_(glassy-winged_sharpshooter)	Bacteria;Actinobacteria;Actinobacteria;Corynebacteriales;Nocardiaceae;Rhodococcus
Bacteria;Actinobacteria;Actinobacteria;Frankiales;Geodermatophilaceae;Blastococcus;Plecoglossus_altivelis_(ayu)	Bacteria;Actinobacteria;Actinobacteria;Frankiales;Geodermatophilaceae;Blastococcus
Bacteria;Actinobacteria;Actinobacteria;Micrococcales;Intrasporangiaceae;Ornithinimicrobium;Homalodisca_vitripennis_(glassy-winged_sharpshooter)	Bacteria;Actinobacteria;Actinobacteria;Micrococcales;Intrasporangiaceae;Ornithinimicrobium
Bacteria;Actinobacteria;Actinobacteria;Micrococcales;Microbacteriaceae;Leucobacter;Caenorhabditis_remanei	Bacteria;Actinobacteria;Actinobacteria;Micrococcales;Microbacteriaceae;Leucobacter
Bacteria;Actinobacteria;Actinobacteria;Micrococcales;Microbacteriaceae;Microbacterium;Acinetobacter_johnsonii	Bacteria;Actinobacteria;Actinobacteria;Micrococcales;Microbacteriaceae;Microbacterium
Bacteria;Actinobacteria;Actinobacteria;Micrococcales;Microbacteriaceae;Microbacterium;Acinetobacter_johnsonii	Bacteria;Actinobacteria;Actinobacteria;Micrococcales;Microbacteriaceae;Microbacterium
Bacteria;Actinobacteria;Actinobacteria;Micrococcales;Microbacteriaceae;Microbacterium;Arthrobacter_sp._TM10_7	Bacteria;Actinobacteria;Actinobacteria;Micrococcales;Microbacteriaceae;Microbacterium
Bacteria;Actinobacteria;Actinobacteria;Micrococcales;Microbacteriaceae;Microbacterium;Azotobacter_vinelandii	Bacteria;Actinobacteria;Actinobacteria;Micrococcales;Microbacteriaceae;Microbacterium
Bacteria;Actinobacteria;Actinobacteria;Micrococcales;Microbacteriaceae;Microbacterium;Bacillus_subtilis	Bacteria;Actinobacteria;Actinobacteria;Micrococcales;Microbacteriaceae;Microbacterium
Bacteria;Actinobacteria;Actinobacteria;Micrococcales;Microbacteriaceae;Microbacterium;Beta_vulgaris_subsp._vulgaris	Bacteria;Actinobacteria;Actinobacteria;Micrococcales;Microbacteriaceae;Microbacterium
Bacteria;Actinobacteria;Actinobacteria;Micrococcales;Microbacteriaceae;Microbacterium;Brevibacillus_agri	Bacteria;Actinobacteria;Actinobacteria;Micrococcales;Microbacteriaceae;Microbacterium
Bacteria;Actinobacteria;Actinobacteria;Micrococcales;Microbacteriaceae;Microbacterium;Brevundimonas_sp._MS48	Bacteria;Actinobacteria;Actinobacteria;Micrococcales;Microbacteriaceae;Microbacterium
Bacteria;Actinobacteria;Actinobacteria;Micrococcales;Microbacteriaceae;Microbacterium;Cellulosimicrobium_cellulans	Bacteria;Actinobacteria;Actinobacteria;Micrococcales;Microbacteriaceae;Microbacterium
Bacteria;Actinobacteria;Actinobacteria;Micrococcales;Microbacteriaceae;Microbacterium;Cellulosimicrobium_sp._6A12S5	Bacteria;Actinobacteria;Actinobacteria;Micrococcales;Microbacteriaceae;Microbacterium
Bacteria;Actinobacteria;Actinobacteria;Micrococcales;Microbacteriaceae;Microbacterium;Citrus_greening_disease-associated_bacterium	Bacteria;Actinobacteria;Actinobacteria;Micrococcales;Microbacteriaceae;Microbacterium
Bacteria;Actinobacteria;Actinobacteria;Micrococcales;Microbacteriaceae;Microbacterium;Corynebacterium_alkanolyticum	Bacteria;Actinobacteria;Actinobacteria;Micrococcales;Microbacteriaceae;Microbacterium
Bacteria;Actinobacteria;Actinobacteria;Micrococcales;Microbacteriaceae;Microbacterium;Curtobacterium_sp._SA11	Bacteria;Actinobacteria;Actinobacteria;Micrococcales;Microbacteriaceae;Microbacterium
Bacteria;Actinobacteria;Actinobacteria;Micrococcales;Microbacteriaceae;Microbacterium;Curtobacterium_sp._VKM_Ac-2057	Bacteria;Actinobacteria;Actinobacteria;Micrococcales;Microbacteriaceae;Microbacterium
Bacteria;Actinobacteria;Actinobacteria;Micrococcales;Microbacteriaceae;Microbacterium;Curtobacterium_sp._VKM_Ac-2061	Bacteria;Actinobacteria;Actinobacteria;Micrococcales;Microbacteriaceae;Microbacterium
Bacteria;Actinobacteria;Actinobacteria;Micrococcales;Microbacteriaceae;Microbacterium;Lucilia_cuprina_(Australian_sheep_blowfly)	Bacteria;Actinobacteria;Actinobacteria;Micrococcales;Microbacteriaceae;Microbacterium
Bacteria;Actinobacteria;Actinobacteria;Micrococcales;Micrococcaceae;Arthrobacter;Streptomyces_libani_subsp._libani	Bacteria;Actinobacteria;Actinobacteria;Micrococcales;Micrococcaceae;Arthrobacter
Bacteria;Actinobacteria;Actinobacteria;Micrococcales;Micrococcaceae;Kocuria;Streptomyces_carnosus	Bacteria;Actinobacteria;Actinobacteria;Micrococcales;Micrococcaceae;Kocuria
Bacteria;Actinobacteria;Actinobacteria;Micrococcales;Micrococcaceae;Micrococcus;Gemella_haemolysans	Bacteria;Actinobacteria;Actinobacteria;Micrococcales;Micrococcaceae;Micrococcus
Bacteria;Actinobacteria;Actinobacteria;Micrococcales;Micrococcaceae;Nesterenkonia;Corynebacteriaceae_(Coryneform_bacteria)	Bacteria;Actinobacteria;Actinobacteria;Micrococcales;Micrococcaceae;Nesterenkonia
Bacteria;Actinobacteria;Actinobacteria;Micrococcales;Micrococcaceae;Paeniglutamicibacter;Amia_calva_(bowfin)	Bacteria;Actinobacteria;Actinobacteria;Micrococcales;Micrococcaceae;Paeniglutamicibacter
Bacteria;Actinobacteria;Actinobacteria;Micrococcales;Micrococcaceae;Pseudarthrobacter;Bacillus_cereus	Bacteria;Actinobacteria;Actinobacteria;Micrococcales;Micrococcaceae;Pseudarthrobacter
Bacteria;Actinobacteria;Actinobacteria;Micrococcales;Micrococcaceae;Pseudarthrobacter;Kocuria_rhizophila	Bacteria;Actinobacteria;Actinobacteria;Micrococcales;Micrococcaceae;Pseudarthrobacter
Bacteria;Actinobacteria;Actinobacteria;Micrococcales;Micrococcaceae;Pseudarthrobacter;Nesterenkonia_sp.	Bacteria;Actinobacteria;Actinobacteria;Micrococcales;Micrococcaceae;Pseudarthrobacter
Bacteria;Actinobacteria;Actinobacteria;Micrococcales;Micrococcaceae;Pseudarthrobacter;Novosphingobium_sp._Leaf2	Bacteria;Actinobacteria;Actinobacteria;Micrococcales;Micrococcaceae;Pseudarthrobacter
Bacteria;Actinobacteria;Actinobacteria;Micrococcales;Micrococcaceae;Pseudarthrobacter;Paenarthrobacter_nicotinovorans	Bacteria;Actinobacteria;Actinobacteria;Micrococcales;Micrococcaceae;Pseudarthrobacter
Bacteria;Actinobacteria;Actinobacteria;Micrococcales;Micrococcaceae;Pseudarthrobacter;Paenarthrobacter_ureafaciens	Bacteria;Actinobacteria;Actinobacteria;Micrococcales;Micrococcaceae;Pseudarthrobacter
Bacteria;Actinobacteria;Actinobacteria;Micrococcales;Micrococcaceae;Pseudarthrobacter;Paenibacillus_sp._tsz10	Bacteria;Actinobacteria;Actinobacteria;Micrococcales;Micrococcaceae;Pseudarthrobacter
Bacteria;Actinobacteria;Actinobacteria;Micrococcales;Micrococcaceae;Rothia;Bacillus_infantis	Bacteria;Actinobacteria;Actinobacteria;Micrococcales;Micrococcaceae;Rothia
Bacteria;Actinobacteria;Actinobacteria;Micrococcales;Micrococcaceae;Rothia;Mycobacterium_abscessus_subsp._abscessus	acteria;Actinobacteria;Actinobacteria;Micrococcales;Micrococcaceae;Rothia
Bacteria;Actinobacteria;Actinobacteria;Micrococcales;Micrococcaceae;Rothia;Mycobacterium_abscessus_subsp._bolletii	acteria;Actinobacteria;Actinobacteria;Micrococcales;Micrococcaceae;Rothia
Bacteria;Actinobacteria;Actinobacteria;Micrococcales;Promicromonosporaceae;Promicromonospora;Streptomyces_noboritoensis	Bacteria;Actinobacteria;Actinobacteria;Micrococcales;Promicromonosporaceae;Promicromonospora
Bacteria;Actinobacteria;Actinobacteria;Micromonosporales;Micromonosporaceae;Actinoplanes;Persicaria_minor	Bacteria;Actinobacteria;Actinobacteria;Micromonosporales;Micromonosporaceae;Actinoplanes
Bacteria;Actinobacteria;Actinobacteria;Micromonosporales;Micromonosporaceae;Micromonospora;Frankia_sp.	Bacteria;Actinobacteria;Actinobacteria;Micromonosporales;Micromonosporaceae;Micromonospora
Bacteria;Actinobacteria;Actinobacteria;Micromonosporales;Micromonosporaceae;Micromonospora;Frankia_sp._BMG5.6	Bacteria;Actinobacteria;Actinobacteria;Micromonosporales;Micromonosporaceae;Micromonospora
Bacteria;Actinobacteria;Actinobacteria;Micromonosporales;Micromonosporaceae;Micromonospora;Juncus_effusus	Bacteria;Actinobacteria;Actinobacteria;Micromonosporales;Micromonosporaceae;Micromonospora
Bacteria;Actinobacteria;Actinobacteria;Micromonosporales;Micromonosporaceae;Micromonospora;Paenibacillus_glucanolyticus	Bacteria;Actinobacteria;Actinobacteria;Micromonosporales;Micromonosporaceae;Micromonospora
Bacteria;Actinobacteria;Actinobacteria;Micromonosporales;Micromonosporaceae;Micromonospora;Streptomyces_angustmyceticus	Bacteria;Actinobacteria;Actinobacteria;Micromonosporales;Micromonosporaceae;Micromonospora
Bacteria;Actinobacteria;Actinobacteria;Micromonosporales;Micromonosporaceae;Micromonospora;Streptomyces_peucetius_subsp._caesius	Bacteria;Actinobacteria;Actinobacteria;Micromonosporales;Micromonosporaceae;Micromonospora
Bacteria;Actinobacteria;Actinobacteria;Micromonosporales;Micromonosporaceae;Micromonospora;Streptomyces_sp.	Bacteria;Actinobacteria;Actinobacteria;Micromonosporales;Micromonosporaceae;Micromonospora
Bacteria;Actinobacteria;Actinobacteria;Micromonosporales;Micromonosporaceae;Micromonospora;Streptomyces_sp._FiRo14	Bacteria;Actinobacteria;Actinobacteria;Micromonosporales;Micromonosporaceae;Micromonospora
Bacteria;Actinobacteria;Actinobacteria;Propionibacteriales;Propionibacteriaceae;Aestuariimicrobium;Mycobacterium_abscessus_subsp._abscessus	Bacteria;Actinobacteria;Actinobacteria;Propionibacteriales;Propionibacteriaceae;Aestuariimicrobium
Bacteria;Actinobacteria;Actinobacteria;Propionibacteriales;Propionibacteriaceae;Cutibacterium;Acidithiobacillus_thiooxidans	Bacteria;Actinobacteria;Actinobacteria;Propionibacteriales;Propionibacteriaceae;Cutibacterium
Bacteria;Actinobacteria;Actinobacteria;Propionibacteriales;Propionibacteriaceae;Cutibacterium;Aureobasidium_melanogenum	Bacteria;Actinobacteria;Actinobacteria;Propionibacteriales;Propionibacteriaceae;Cutibacterium
Bacteria;Actinobacteria;Actinobacteria;Propionibacteriales;Propionibacteriaceae;Cutibacterium;Bacillus_licheniformis	Bacteria;Actinobacteria;Actinobacteria;Propionibacteriales;Propionibacteriaceae;Cutibacterium
Bacteria;Actinobacteria;Actinobacteria;Propionibacteriales;Propionibacteriaceae;Cutibacterium;Coregonus_clupeaformis_(lake_whitefish)	Bacteria;Actinobacteria;Actinobacteria;Propionibacteriales;Propionibacteriaceae;Cutibacterium
Bacteria;Actinobacteria;Actinobacteria;Propionibacteriales;Propionibacteriaceae;Cutibacterium;Coregonus_lavaretus_(common_whitefish)	Bacteria;Actinobacteria;Actinobacteria;Propionibacteriales;Propionibacteriaceae;Cutibacterium
Bacteria;Actinobacteria;Actinobacteria;Propionibacteriales;Propionibacteriaceae;Cutibacterium;Daphnia_magna	Bacteria;Actinobacteria;Actinobacteria;Propionibacteriales;Propionibacteriaceae;Cutibacterium
Bacteria;Actinobacteria;Actinobacteria;Propionibacteriales;Propionibacteriaceae;Cutibacterium;Lepisosteus_oculatus_(spotted_gar)	Bacteria;Actinobacteria;Actinobacteria;Propionibacteriales;Propionibacteriaceae;Cutibacterium
Bacteria;Actinobacteria;Actinobacteria;Propionibacteriales;Propionibacteriaceae;Cutibacterium;Mycobacterium_chitae	Bacteria;Actinobacteria;Actinobacteria;Propionibacteriales;Propionibacteriaceae;Cutibacterium
Bacteria;Actinobacteria;Actinobacteria;Propionibacteriales;Propionibacteriaceae;Microlunatus;Osteoglossum_bicirrhosum_(silver_arawana)	Bacteria;Actinobacteria;Actinobacteria;Propionibacteriales;Propionibacteriaceae;Microlunatus
Bacteria;Actinobacteria;Actinobacteria;Pseudonocardiales;Pseudonocardiaceae;Actinophytocola;Punica_granatum_(pomegranate)	Bacteria;Actinobacteria;Actinobacteria;Pseudonocardiales;Pseudonocardiaceae;Actinophytocola
Bacteria;Actinobacteria;Actinobacteria;Streptomycetales;Streptomycetaceae;Streptomyces;Actinoalloteichus_cyanogriseus	Bacteria;Actinobacteria;Actinobacteria;Streptomycetales;Streptomycetaceae;Streptomyces
Bacteria;Actinobacteria;Actinobacteria;Streptomycetales;Streptomycetaceae;Streptomyces;Actinomadura_madurae	Bacteria;Actinobacteria;Actinobacteria;Streptomycetales;Streptomycetaceae;Streptomyces
Bacteria;Actinobacteria;Actinobacteria;Streptomycetales;Streptomycetaceae;Streptomyces;Actinomadura_sp._FXJ1.821	Bacteria;Actinobacteria;Actinobacteria;Streptomycetales;Streptomycetaceae;Streptomyces
Bacteria;Actinobacteria;Actinobacteria;Streptomycetales;Streptomycetaceae;Streptomyces;Actinomyces_sp._GP1	Bacteria;Actinobacteria;Actinobacteria;Streptomycetales;Streptomycetaceae;Streptomyces
Bacteria;Actinobacteria;Actinobacteria;Streptomycetales;Streptomycetaceae;Streptomyces;Actinomyces_sp._MC1	Bacteria;Actinobacteria;Actinobacteria;Streptomycetales;Streptomycetaceae;Streptomyces
Bacteria;Actinobacteria;Actinobacteria;Streptomycetales;Streptomycetaceae;Streptomyces;Actinomyces_sp._sw20	Bacteria;Actinobacteria;Actinobacteria;Streptomycetales;Streptomycetaceae;Streptomyces
Bacteria;Actinobacteria;Actinobacteria;Streptomycetales;Streptomycetaceae;Streptomyces;Actinosporangium_sp._NRRL_B-3428	Bacteria;Actinobacteria;Actinobacteria;Streptomycetales;Streptomycetaceae;Streptomyces
Bacteria;Actinobacteria;Actinobacteria;Streptomycetales;Streptomycetaceae;Streptomyces;Bacillus_amyloliquefaciens	Bacteria;Actinobacteria;Actinobacteria;Streptomycetales;Streptomycetaceae;Streptomyces
Bacteria;Actinobacteria;Actinobacteria;Streptomycetales;Streptomycetaceae;Streptomyces;Bacillus_sp._W27	Bacteria;Actinobacteria;Actinobacteria;Streptomycetales;Streptomycetaceae;Streptomyces
Bacteria;Actinobacteria;Actinobacteria;Streptomycetales;Streptomycetaceae;Streptomyces;Bacillus_subtilis	Bacteria;Actinobacteria;Actinobacteria;Streptomycetales;Streptomycetaceae;Streptomyces
Bacteria;Actinobacteria;Actinobacteria;Streptomycetales;Streptomycetaceae;Streptomyces;Globodera_pallida	Bacteria;Actinobacteria;Actinobacteria;Streptomycetales;Streptomycetaceae;Streptomyces
Bacteria;Actinobacteria;Actinobacteria;Streptomycetales;Streptomycetaceae;Streptomyces;Herbaspirillum_sp._FSBSN5	Bacteria;Actinobacteria;Actinobacteria;Streptomycetales;Streptomycetaceae;Streptomyces
Bacteria;Actinobacteria;Actinobacteria;Streptomycetales;Streptomycetaceae;Streptomyces;Kocuria_sp._BPSAC176	Bacteria;Actinobacteria;Actinobacteria;Streptomycetales;Streptomycetaceae;Streptomyces
Bacteria;Actinobacteria;Actinobacteria;Streptomycetales;Streptomycetaceae;Streptomyces;Micromonospora_megalomicea	Bacteria;Actinobacteria;Actinobacteria;Streptomycetales;Streptomycetaceae;Streptomyces
Bacteria;Actinobacteria;Actinobacteria;Streptomycetales;Streptomycetaceae;Streptomyces;Micromonospora_sp._HCZ26	Bacteria;Actinobacteria;Actinobacteria;Streptomycetales;Streptomycetaceae;Streptomyces
Bacteria;Actinobacteria;Actinobacteria;Streptomycetales;Streptomycetaceae;Streptomyces;Microtetraspora_glauca	Bacteria;Actinobacteria;Actinobacteria;Streptomycetales;Streptomycetaceae;Streptomyces
Bacteria;Actinobacteria;Actinobacteria;Streptomycetales;Streptomycetaceae;Streptomyces;Nocardia_cummidelens	Bacteria;Actinobacteria;Actinobacteria;Streptomycetales;Streptomycetaceae;Streptomyces
Bacteria;Actinobacteria;Actinobacteria;Streptomycetales;Streptomycetaceae;Streptomyces;Nocardia_sp._JJE-2	Bacteria;Actinobacteria;Actinobacteria;Streptomycetales;Streptomycetaceae;Streptomyces
Bacteria;Actinobacteria;Actinobacteria;Streptomycetales;Streptomycetaceae;Streptomyces;Nocardiopsis_sp._10035	Bacteria;Actinobacteria;Actinobacteria;Streptomycetales;Streptomycetaceae;Streptomyces
Bacteria;Actinobacteria;Actinobacteria;Streptomycetales;Streptomycetaceae;Streptomyces;Nocardiopsis_sp._A322_Ydz-QZ	Bacteria;Actinobacteria;Actinobacteria;Streptomycetales;Streptomycetaceae;Streptomyces
Bacteria;Actinobacteria;Actinobacteria;Streptomycetales;Streptomycetaceae;Streptomyces;Nocardiopsis_sp._D32104	Bacteria;Actinobacteria;Actinobacteria;Streptomycetales;Streptomycetaceae;Streptomyces
Bacteria;Actinobacteria;Actinobacteria;Streptomycetales;Streptomycetaceae;Streptomyces;Nocardiopsis_sp._HT29-2_Ydz-XM	Bacteria;Actinobacteria;Actinobacteria;Streptomycetales;Streptomycetaceae;Streptomyces
Bacteria;Actinobacteria;Actinobacteria;Streptomycetales;Streptomycetaceae;Streptomyces;Nocardiopsis_sp._TRM46229	Bacteria;Actinobacteria;Actinobacteria;Streptomycetales;Streptomycetaceae;Streptomyces
Bacteria;Actinobacteria;Actinobacteria;Streptomycetales;Streptomycetaceae;Streptomyces;Nocardiopsis_synnemasporogenes	Bacteria;Actinobacteria;Actinobacteria;Streptomycetales;Streptomycetaceae;Streptomyces
Bacteria;Actinobacteria;Actinobacteria;Streptomycetales;Streptomycetaceae;Streptomyces;Talaromyces_islandicus	Bacteria;Actinobacteria;Actinobacteria;Streptomycetales;Streptomycetaceae;Streptomyces
Bacteria;Actinobacteria;Actinobacteria;Streptosporangiales;Nocardiopsaceae;Nocardiopsis;Actinomycetaceae	Bacteria;Actinobacteria;Actinobacteria;Streptosporangiales;Nocardiopsaceae;Nocardiopsis
Bacteria;Actinobacteria;Actinobacteria;Streptosporangiales;Nocardiopsaceae;Nocardiopsis;Promicromonospora_aerolata	Bacteria;Actinobacteria;Actinobacteria;Streptosporangiales;Nocardiopsaceae;Nocardiopsis
Bacteria;Actinobacteria;Actinobacteria;Streptosporangiales;Nocardiopsaceae;Nocardiopsis;Triticum_urartu	Bacteria;Actinobacteria;Actinobacteria;Streptosporangiales;Nocardiopsaceae;Nocardiopsis
Bacteria;Actinobacteria;Actinobacteria;Streptosporangiales;Nocardiopsaceae;Nocardiopsis;Triticum_urartu	Bacteria;Actinobacteria;Actinobacteria;Streptosporangiales;Nocardiopsaceae;Nocardiopsis
Bacteria;Actinobacteria;Actinobacteria;Streptosporangiales;Thermomonosporaceae;Actinomadura;Mycobacterium_tuberculosis	Bacteria;Actinobacteria;Actinobacteria;Streptosporangiales;Thermomonosporaceae;Actinomadura
Bacteria;Actinobacteria;Actinobacteria;Streptosporangiales;Thermomonosporaceae;Actinomadura;Parvopolyspora_pallida	Bacteria;Actinobacteria;Actinobacteria;Streptosporangiales;Thermomonosporaceae;Actinomadura
Bacteria;Actinobacteria;Coriobacteriia;Coriobacteriales;Atopobiaceae;Atopobium;Chlamydia_trachomatis	Bacteria;Actinobacteria;Coriobacteriia;Coriobacteriales;Atopobiaceae;Atopobium
Bacteria;Bacteroidetes;Bacteroidia;Bacteroidales;Bacteroidaceae;Bacteroides;Blattella_germanica_(German_cockroach)	Bacteria;Bacteroidetes;Bacteroidia;Bacteroidales;Bacteroidaceae;Bacteroides
Bacteria;Bacteroidetes;Bacteroidia;Bacteroidales;Bacteroidaceae;Bacteroides;Catenibacterium_mitsuokai	Bacteria;Bacteroidetes;Bacteroidia;Bacteroidales;Bacteroidaceae;Bacteroides
Bacteria;Bacteroidetes;Bacteroidia;Bacteroidales;Bacteroidaceae;Bacteroides;Dorea_longicatena	Bacteria;Bacteroidetes;Bacteroidia;Bacteroidales;Bacteroidaceae;Bacteroides
Bacteria;Bacteroidetes;Bacteroidia;Bacteroidales;Barnesiellaceae;Coprobacter;Gabonia_massiliensis	Bacteria;Bacteroidetes;Bacteroidia;Bacteroidales;Barnesiellaceae;Coprobacter
Bacteria;Bacteroidetes;Bacteroidia;Bacteroidales;Dysgonomonadaceae;Candidatus_Armantifilum;Coptotermes_gestroi	Bacteria;Bacteroidetes;Bacteroidia;Bacteroidales;Dysgonomonadaceae;Candidatus_Armantifilum
Bacteria;Bacteroidetes;Bacteroidia;Bacteroidales;Dysgonomonadaceae;Candidatus_Azobacteroides;Coptotermes_gestroi	Bacteria;Bacteroidetes;Bacteroidia;Bacteroidales;Dysgonomonadaceae;Candidatus_Azobacteroides
Bacteria;Bacteroidetes;Bacteroidia;Bacteroidales;Dysgonomonadaceae;Dysgonomonas;Blattella_germanica_(German_cockroach)	Bacteria;Bacteroidetes;Bacteroidia;Bacteroidales;Dysgonomonadaceae;Dysgonomonas
Bacteria;Bacteroidetes;Bacteroidia;Bacteroidales;Dysgonomonadaceae;Proteiniphilum;Bacteroides_sp._22C	Bacteria;Bacteroidetes;Bacteroidia;Bacteroidales;Dysgonomonadaceae;Proteiniphilum
Bacteria;Bacteroidetes;Bacteroidia;Bacteroidales;Paludibacteraceae;Paludibacter;Blattella_germanica_(German_cockroach)	Bacteria;Bacteroidetes;Bacteroidia;Bacteroidales;Paludibacteraceae;Paludibacter
Bacteria;Bacteroidetes;Bacteroidia;Bacteroidales;Porphyromonadaceae;Porphyromonas;Porites_australiensis	Bacteria;Bacteroidetes;Bacteroidia;Bacteroidales;Porphyromonadaceae;Porphyromonas
Bacteria;Bacteroidetes;Bacteroidia;Bacteroidales;Prevotellaceae;Prevotella_9;Trichuris_trichiura_(human_whipworm)	Bacteria;Bacteroidetes;Bacteroidia;Bacteroidales;Prevotellaceae;Prevotella_9
Bacteria;Bacteroidetes;Bacteroidia;Bacteroidales;Prevotellaceae;Prevotella;Chlamydia_trachomatis	Bacteria;Bacteroidetes;Bacteroidia;Bacteroidales;Prevotellaceae;Prevotella
Bacteria;Bacteroidetes;Bacteroidia;Bacteroidales;Prevotellaceae;Prevotella;Chlamydia_trachomatis	Bacteria;Bacteroidetes;Bacteroidia;Bacteroidales;Prevotellaceae;Prevotella
Bacteria;Bacteroidetes;Bacteroidia;Bacteroidales;Prolixibacteraceae;BSV13;Ephemera_danica	Bacteria;Bacteroidetes;Bacteroidia;Bacteroidales;Prolixibacteraceae;BSV13
Bacteria;Bacteroidetes;Bacteroidia;Bacteroidales;Prolixibacteraceae;Roseimarinus;Cytophaga_sp._AN-BI4	Bacteria;Bacteroidetes;Bacteroidia;Bacteroidales;Prolixibacteraceae;Roseimarinus
Bacteria;Bacteroidetes;Bacteroidia;Bacteroidales;Prolixibacteraceae;uncultured;Ephemera_danica	Bacteria;Bacteroidetes;Bacteroidia;Bacteroidales;Prolixibacteraceae
Bacteria;Bacteroidetes;Bacteroidia;Bacteroidales;Rikenellaceae;Alistipes;Bacteroides_sp._CCUG_39913	Bacteria;Bacteroidetes;Bacteroidia;Bacteroidales;Rikenellaceae;Alistipes
Bacteria;Bacteroidetes;Bacteroidia;Bacteroidales;Rikenellaceae;Alistipes;Bacteroides_sp._DSM_12148	Bacteria;Bacteroidetes;Bacteroidia;Bacteroidales;Rikenellaceae;Alistipes
Bacteria;Bacteroidetes;Bacteroidia;Bacteroidales;Rikenellaceae;Alistipes;Bacteroides_sp._Smarlab_3302398	Bacteria;Bacteroidetes;Bacteroidia;Bacteroidales;Rikenellaceae;Alistipes
Bacteria;Bacteroidetes;Bacteroidia;Bacteroidales;Rikenellaceae;Alistipes;Faecalibacterium_prausnitzii	Bacteria;Bacteroidetes;Bacteroidia;Bacteroidales;Rikenellaceae;Alistipes
Bacteria;Bacteroidetes;Bacteroidia;Bacteroidales;Rikenellaceae;Rikenella;Gadus_morhua_(Atlantic_cod)	Bacteria;Bacteroidetes;Bacteroidia;Bacteroidales;Rikenellaceae;Rikenella
Bacteria;Bacteroidetes;Bacteroidia;Bacteroidales;Tannerellaceae;Candidatus_Vestibaculum;Coptotermes_gestroi	Bacteria;Bacteroidetes;Bacteroidia;Bacteroidales;Tannerellaceae;Candidatus_Vestibaculum
Bacteria;Bacteroidetes;Bacteroidia;Bacteroidales;Tannerellaceae;Macellibacteroides;Bacteroides_sp._strain_Z4	Bacteria;Bacteroidetes;Bacteroidia;Bacteroidales;Tannerellaceae;Macellibacteroides
Bacteria;Bacteroidetes;Bacteroidia;Bacteroidales;Tannerellaceae;Parabacteroides;Blattella_germanica_(German_cockroach)	Bacteria;Bacteroidetes;Bacteroidia;Bacteroidales;Tannerellaceae;Parabacteroides
Bacteria;Bacteroidetes;Bacteroidia;Bacteroidales;Tannerellaceae;Parabacteroides;Gryllus_firmus	Bacteria;Bacteroidetes;Bacteroidia;Bacteroidales;Tannerellaceae;Parabacteroides
Bacteria;Bacteroidetes;Bacteroidia;Bacteroidales;Tannerellaceae;Tannerella;Bacteroides	Bacteria;Bacteroidetes;Bacteroidia;Bacteroidales;Tannerellaceae;Tannerella
Bacteria;Bacteroidetes;Bacteroidia;Chitinophagales;Chitinophagaceae;Ferruginibacter;Hypsibius_dujardini	Bacteria;Bacteroidetes;Bacteroidia;Chitinophagales;Chitinophagaceae;Ferruginibacter
Bacteria;Bacteroidetes;Bacteroidia;Chitinophagales;Chitinophagaceae;Sediminibacterium;Hypsibius_dujardini	Bacteria;Bacteroidetes;Bacteroidia;Chitinophagales;Chitinophagaceae;Sediminibacterium
Bacteria;Bacteroidetes;Bacteroidia;Chitinophagales;Chitinophagaceae;Terrimonas;Hypsibius_dujardini	Bacteria;Bacteroidetes;Bacteroidia;Chitinophagales;Chitinophagaceae;Terrimonas
Bacteria;Bacteroidetes;Bacteroidia;Chitinophagales;Chitinophagaceae;Terrimonas;Trachelomonas_volvocinopsis_var._spiralis	Bacteria;Bacteroidetes;Bacteroidia;Chitinophagales;Chitinophagaceae;Terrimonas
Bacteria;Bacteroidetes;Bacteroidia;Chitinophagales;Chitinophagaceae;uncultured;Spumella-like_flagellate_JBM08	Bacteria;Bacteroidetes;Bacteroidia;Chitinophagales;Chitinophagaceae;
Bacteria;Bacteroidetes;Bacteroidia;Chitinophagales;Chitinophagaceae;Vibrionimonas;Sediminibacterium_sp._I-32	Bacteria;Bacteroidetes;Bacteroidia;Chitinophagales;Chitinophagaceae;Vibrionimonas
Bacteria;Bacteroidetes;Bacteroidia;Chitinophagales;Chitinophagaceae;Vibrionimonas;Sediminibacterium_sp._LT21-MRL	Bacteria;Bacteroidetes;Bacteroidia;Chitinophagales;Chitinophagaceae;Vibrionimonas
Bacteria;Bacteroidetes;Bacteroidia;Chitinophagales;Saprospiraceae;Lewinella;Cladosiphon_okamuranus	Bacteria;Bacteroidetes;Bacteroidia;Chitinophagales;Saprospiraceae;Lewinella
Bacteria;Bacteroidetes;Bacteroidia;Chitinophagales;Saprospiraceae;Rubidimonas;Tigriopus_californicus	Bacteria;Bacteroidetes;Bacteroidia;Chitinophagales;Saprospiraceae;Rubidimonas
Bacteria;Bacteroidetes;Bacteroidia;Chitinophagales;Saprospiraceae;uncultured;Ephemera_danica	Bacteria;Bacteroidetes;Bacteroidia;Chitinophagales;Saprospiraceae
Bacteria;Bacteroidetes;Bacteroidia;Chitinophagales;Saprospiraceae;uncultured;Saccharina_japonica	Bacteria;Bacteroidetes;Bacteroidia;Chitinophagales;Saprospiraceae;
Bacteria;Bacteroidetes;Bacteroidia;Chitinophagales;Saprospiraceae;uncultured;Sargassum_vachellianum	Bacteria;Bacteroidetes;Bacteroidia;Chitinophagales;Saprospiraceae;
Bacteria;Bacteroidetes;Bacteroidia;Cytophagales;Amoebophilaceae;Candidatus_Amoebophilus;Dictyostelium_polycephalum	Bacteria;Bacteroidetes;Bacteroidia;Cytophagales;Amoebophilaceae;Candidatus_Amoebophilus
Bacteria;Bacteroidetes;Bacteroidia;Cytophagales;Amoebophilaceae;Candidatus_Amoebophilus;Diplonema_papillatum	Bacteria;Bacteroidetes;Bacteroidia;Cytophagales;Amoebophilaceae;Candidatus_Amoebophilus
Bacteria;Bacteroidetes;Bacteroidia;Cytophagales;Cyclobacteriaceae;Algoriphagus;Flexibacter_sp._cu2i-19	Bacteria;Bacteroidetes;Bacteroidia;Cytophagales;Cyclobacteriaceae;Algoriphagus
Bacteria;Bacteroidetes;Bacteroidia;Cytophagales;Cyclobacteriaceae;Algoriphagus;Flexibacteraceae_bacterium_JAM-BA0103	Bacteria;Bacteroidetes;Bacteroidia;Cytophagales;Cyclobacteriaceae;Algoriphagus
Bacteria;Bacteroidetes;Bacteroidia;Cytophagales;Cyclobacteriaceae;Algoriphagus;Sphingobacterium_sp._BF02-S7	Bacteria;Bacteroidetes;Bacteroidia;Cytophagales;Cyclobacteriaceae;Algoriphagus
Bacteria;Bacteroidetes;Bacteroidia;Cytophagales;Cyclobacteriaceae;Marinoscillum;Saccharina_japonica	Bacteria;Bacteroidetes;Bacteroidia;Cytophagales;Cyclobacteriaceae;Marinoscillum
Bacteria;Bacteroidetes;Bacteroidia;Cytophagales;Cyclobacteriaceae;Nafulsella;Rhinopithecus_roxellana_(golden_snub-nosed_monkey)	Bacteria;Bacteroidetes;Bacteroidia;Cytophagales;Cyclobacteriaceae;Nafulsella
Bacteria;Bacteroidetes;Bacteroidia;Cytophagales;Cyclobacteriaceae;Roseivirga;Thalassiosira_rotula	Bacteria;Bacteroidetes;Bacteroidia;Cytophagales;Cyclobacteriaceae;Roseivirga
Bacteria;Bacteroidetes;Bacteroidia;Cytophagales;Cyclobacteriaceae;Shivajiella;Fodinibacter_sp._S2	Bacteria;Bacteroidetes;Bacteroidia;Cytophagales;Cyclobacteriaceae;Shivajiella
Bacteria;Bacteroidetes;Bacteroidia;Cytophagales;Cytophagaceae;Cytophaga;Hypsibius_dujardini	Bacteria;Bacteroidetes;Bacteroidia;Cytophagales;Cytophagaceae;Cytophaga
Bacteria;Bacteroidetes;Bacteroidia;Cytophagales;Hymenobacteraceae;Hymenobacter;Amia_calva_(bowfin)	Bacteria;Bacteroidetes;Bacteroidia;Cytophagales;Hymenobacteraceae;Hymenobacter
Bacteria;Bacteroidetes;Bacteroidia;Cytophagales;Hymenobacteraceae;Hymenobacter;Deinococcus_sp._6A2	Bacteria;Bacteroidetes;Bacteroidia;Cytophagales;Hymenobacteraceae;Hymenobacter
Bacteria;Bacteroidetes;Bacteroidia;Cytophagales;Hymenobacteraceae;Hymenobacter;Macrotyloma_uniflorum	Bacteria;Bacteroidetes;Bacteroidia;Cytophagales;Hymenobacteraceae;Hymenobacter
Bacteria;Bacteroidetes;Bacteroidia;Cytophagales;Hymenobacteraceae;Hymenobacter;Thymallus_thymallus_(grayling)	Bacteria;Bacteroidetes;Bacteroidia;Cytophagales;Hymenobacteraceae;Hymenobacter
Bacteria;Bacteroidetes;Bacteroidia;Cytophagales;Hymenobacteraceae;Hymenobacter;Triticum_aestivum_(bread_wheat)	Bacteria;Bacteroidetes;Bacteroidia;Cytophagales;Hymenobacteraceae;Hymenobacter
Bacteria;Bacteroidetes;Bacteroidia;Cytophagales;Hymenobacteraceae;Pontibacter;Bacteroides_sp._MBF11	Bacteria;Bacteroidetes;Bacteroidia;Cytophagales;Hymenobacteraceae;Pontibacter
Bacteria;Bacteroidetes;Bacteroidia;Cytophagales;Microscillaceae;Ohtaekwangia;Globodera_pallida	Bacteria;Bacteroidetes;Bacteroidia;Cytophagales;Microscillaceae;Ohtaekwangia
Bacteria;Bacteroidetes;Bacteroidia;Cytophagales;Spirosomaceae;Arsenicibacter;Cenchrus_americanus	Bacteria;Bacteroidetes;Bacteroidia;Cytophagales;Spirosomaceae;Arsenicibacter
Bacteria;Bacteroidetes;Bacteroidia;Cytophagales;Spirosomaceae;Dyadobacter;Sphingobacterium_sp._32	Bacteria;Bacteroidetes;Bacteroidia;Cytophagales;Spirosomaceae;Dyadobacter
Bacteria;Bacteroidetes;Bacteroidia;Cytophagales;Spirosomaceae;Dyadobacter;Spumella-like_flagellate_JBM08	Bacteria;Bacteroidetes;Bacteroidia;Cytophagales;Spirosomaceae;Dyadobacter
Bacteria;Bacteroidetes;Bacteroidia;Cytophagales;Spirosomaceae;Fibrisoma;Cenchrus_americanus	Bacteria;Bacteroidetes;Bacteroidia;Cytophagales;Spirosomaceae;Fibrisoma
Bacteria;Bacteroidetes;Bacteroidia;Cytophagales;Spirosomaceae;Lacihabitans;Hyalella_azteca	Bacteria;Bacteroidetes;Bacteroidia;Cytophagales;Spirosomaceae;Lacihabitans
Bacteria;Bacteroidetes;Bacteroidia;Cytophagales;Spirosomaceae;uncultured;Dyadobacter_sp._enrichment_culture	Bacteria;Bacteroidetes;Bacteroidia;Cytophagales;Spirosomaceae;
Bacteria;Bacteroidetes;Bacteroidia;Cytophagales;Spirosomaceae;uncultured;Ephemera_danica	Bacteria;Bacteroidetes;Bacteroidia;Cytophagales;Spirosomaceae
Bacteria;Bacteroidetes;Bacteroidia;Flavobacteriales;Blattabacteriaceae;Blattabacterium;Periplaneta_americana_(American_cockroach)	Bacteria;Bacteroidetes;Bacteroidia;Flavobacteriales;Blattabacteriaceae;Blattabacterium
Bacteria;Bacteroidetes;Bacteroidia;Flavobacteriales;Blattabacteriaceae;Candidatus_Brownia;Flavobacterium;	Bacteria;Bacteroidetes;Bacteroidia;Flavobacteriales;Blattabacteriaceae;Candidatus_Brownia
Bacteria;Bacteroidetes;Bacteroidia;Flavobacteriales;Blattabacteriaceae;Candidatus_Sulcia;Okanagana_villosa	Bacteria;Bacteroidetes;Bacteroidia;Flavobacteriales;Blattabacteriaceae;Candidatus_Sulcia
Bacteria;Bacteroidetes;Bacteroidia;Flavobacteriales;Blattabacteriaceae;Candidatus_Sulcia;Priacma_serrata	Bacteria;Bacteroidetes;Bacteroidia;Flavobacteriales;Blattabacteriaceae;Candidatus_Sulcia
Bacteria;Bacteroidetes;Bacteroidia;Flavobacteriales;Crocinitomicaceae;Fluviicola;Hypsibius_dujardini	Bacteria;Bacteroidetes;Bacteroidia;Flavobacteriales;Crocinitomicaceae;Fluviicola
Bacteria;Bacteroidetes;Bacteroidia;Flavobacteriales;Flavobacteriaceae;Aurantivirga;Flavobacterium_sp._SCGC_AAA160-P02	Bacteria;Bacteroidetes;Bacteroidia;Flavobacteriales;Flavobacteriaceae;Aurantivirga
Bacteria;Bacteroidetes;Bacteroidia;Flavobacteriales;Flavobacteriaceae;Costertonia;Chromera_velia	Bacteria;Bacteroidetes;Bacteroidia;Flavobacteriales;Flavobacteriaceae;Costertonia
Bacteria;Bacteroidetes;Bacteroidia;Flavobacteriales;Flavobacteriaceae;Flavobacterium;Anabaena_sp._WA113	Bacteria;Bacteroidetes;Bacteroidia;Flavobacteriales;Flavobacteriaceae;Flavobacterium
Bacteria;Bacteroidetes;Bacteroidia;Flavobacteriales;Flavobacteriaceae;Flavobacterium;Bragasellus_molinai	Bacteria;Bacteroidetes;Bacteroidia;Flavobacteriales;Flavobacteriaceae;Flavobacterium
Bacteria;Bacteroidetes;Bacteroidia;Flavobacteriales;Flavobacteriaceae;Flavobacterium;Daphnia_magna	Bacteria;Bacteroidetes;Bacteroidia;Flavobacteriales;Flavobacteriaceae;Flavobacterium
Bacteria;Bacteroidetes;Bacteroidia;Flavobacteriales;Flavobacteriaceae;Flavobacterium;Dictyostelium_deminutivum	Bacteria;Bacteroidetes;Bacteroidia;Flavobacteriales;Flavobacteriaceae;Flavobacterium
Bacteria;Bacteroidetes;Bacteroidia;Flavobacteriales;Flavobacteriaceae;Flavobacterium;Eriocheir_sinensis_(Chinese_mitten_crab)	Bacteria;Bacteroidetes;Bacteroidia;Flavobacteriales;Flavobacteriaceae;Flavobacterium
Bacteria;Bacteroidetes;Bacteroidia;Flavobacteriales;Flavobacteriaceae;Flavobacterium;Hydra_vulgaris	Bacteria;Bacteroidetes;Bacteroidia;Flavobacteriales;Flavobacteriaceae;Flavobacterium
Bacteria;Bacteroidetes;Bacteroidia;Flavobacteriales;Flavobacteriaceae;Flavobacterium;Proasellus_cavaticus	Bacteria;Bacteroidetes;Bacteroidia;Flavobacteriales;Flavobacteriaceae;Flavobacterium
Bacteria;Bacteroidetes;Bacteroidia;Flavobacteriales;Flavobacteriaceae;Flavobacterium;Proasellus_grafi	Bacteria;Bacteroidetes;Bacteroidia;Flavobacteriales;Flavobacteriaceae;Flavobacterium
Bacteria;Bacteroidetes;Bacteroidia;Flavobacteriales;Flavobacteriaceae;Flavobacterium;Proasellus_ibericus	Bacteria;Bacteroidetes;Bacteroidia;Flavobacteriales;Flavobacteriaceae;Flavobacterium
Bacteria;Bacteroidetes;Bacteroidia;Flavobacteriales;Flavobacteriaceae;Flavobacterium;Proasellus_parvulus	Bacteria;Bacteroidetes;Bacteroidia;Flavobacteriales;Flavobacteriaceae;Flavobacterium
Bacteria;Bacteroidetes;Bacteroidia;Flavobacteriales;Flavobacteriaceae;Flavobacterium;Proasellus_racovitzai	Bacteria;Bacteroidetes;Bacteroidia;Flavobacteriales;Flavobacteriaceae;Flavobacterium
Bacteria;Bacteroidetes;Bacteroidia;Flavobacteriales;Flavobacteriaceae;Flavobacterium;Proasellus_spelaeus	Bacteria;Bacteroidetes;Bacteroidia;Flavobacteriales;Flavobacteriaceae;Flavobacterium
Bacteria;Bacteroidetes;Bacteroidia;Flavobacteriales;Flavobacteriaceae;Flavobacterium;Trachelomonas_sp._Jakeun052407A	Bacteria;Bacteroidetes;Bacteroidia;Flavobacteriales;Flavobacteriaceae;Flavobacterium
Bacteria;Bacteroidetes;Bacteroidia;Flavobacteriales;Flavobacteriaceae;Flavobacterium;Trachelomonas_sp._Jilnal030207BT	Bacteria;Bacteroidetes;Bacteroidia;Flavobacteriales;Flavobacteriaceae;Flavobacterium
Bacteria;Bacteroidetes;Bacteroidia;Flavobacteriales;Flavobacteriaceae;Formosa;Anurida_maritima	Bacteria;Bacteroidetes;Bacteroidia;Flavobacteriales;Flavobacteriaceae;Formosa
Bacteria;Bacteroidetes;Bacteroidia;Flavobacteriales;Flavobacteriaceae;Tenacibaculum;Porites_australiensis	Bacteria;Bacteroidetes;Bacteroidia;Flavobacteriales;Flavobacteriaceae;Tenacibaculum
Bacteria;Bacteroidetes;Bacteroidia;Flavobacteriales;Weeksellaceae;Apibacter;Ceratina_chalybea	Bacteria;Bacteroidetes;Bacteroidia;Flavobacteriales;Weeksellaceae;Apibacter
Bacteria;Bacteroidetes;Bacteroidia;Flavobacteriales;Weeksellaceae;Chryseobacterium;Bouteloua_dactyloides	Bacteria;Bacteroidetes;Bacteroidia;Flavobacteriales;Weeksellaceae;Chryseobacterium
Bacteria;Bacteroidetes;Bacteroidia;Flavobacteriales;Weeksellaceae;Chryseobacterium;Oryza_sativa_Indica_Group_(long-grained_rice)	Bacteria;Bacteroidetes;Bacteroidia;Flavobacteriales;Weeksellaceae;Chryseobacterium
Bacteria;Bacteroidetes;Bacteroidia;Flavobacteriales;Weeksellaceae;Chryseobacterium;Romanomermis_culicivorax	Bacteria;Bacteroidetes;Bacteroidia;Flavobacteriales;Weeksellaceae;Chryseobacterium
Bacteria;Bacteroidetes;Bacteroidia;Flavobacteriales;Weeksellaceae;Chryseobacterium;Triticum_urartu	Bacteria;Bacteroidetes;Bacteroidia;Flavobacteriales;Weeksellaceae;Chryseobacterium
Bacteria;Bacteroidetes;Bacteroidia;Sphingobacteriales;Sphingobacteriaceae;Mucilaginibacter;Castanea_mollissima_(Chinese_chestnut)	Bacteria;Bacteroidetes;Bacteroidia;Sphingobacteriales;Sphingobacteriaceae;Mucilaginibacter
Bacteria;Bacteroidetes;Bacteroidia;Sphingobacteriales;Sphingobacteriaceae;Mucilaginibacter;Thymallus_thymallus_(grayling)	Bacteria;Bacteroidetes;Bacteroidia;Sphingobacteriales;Sphingobacteriaceae;Mucilaginibacter
Bacteria;Bacteroidetes;Bacteroidia;Sphingobacteriales;Sphingobacteriaceae;Pedobacter;Acytostelium_ellipticum	Bacteria;Bacteroidetes;Bacteroidia;Sphingobacteriales;Sphingobacteriaceae;Pedobacter
Bacteria;Bacteroidetes;Bacteroidia;Sphingobacteriales;Sphingobacteriaceae;Pedobacter;Beta_vulgaris_subsp._vulgaris	Bacteria;Bacteroidetes;Bacteroidia;Sphingobacteriales;Sphingobacteriaceae;Pedobacter
Bacteria;Bacteroidetes;Bacteroidia;Sphingobacteriales;Sphingobacteriaceae;Sphingobacterium;Brassica_oleracea_var._capitata_(cabbage)	Bacteria;Bacteroidetes;Bacteroidia;Sphingobacteriales;Sphingobacteriaceae;Sphingobacterium
Bacteria;Bacteroidetes;Bacteroidia;Sphingobacteriales;Sphingobacteriaceae;Sphingobacterium;Caenorhabditis_elegans	Bacteria;Bacteroidetes;Bacteroidia;Sphingobacteriales;Sphingobacteriaceae;Sphingobacterium
Bacteria;Bacteroidetes;Bacteroidia;Sphingobacteriales;Sphingobacteriaceae;Sphingobacterium;Oryza_sativa_Indica_Group_(long-grained_rice)	Bacteria;Bacteroidetes;Bacteroidia;Sphingobacteriales;Sphingobacteriaceae;Sphingobacterium
Bacteria;Bacteroidetes;Bacteroidia;Sphingobacteriales;Sphingobacteriaceae;Sphingobacterium;Triticum_urartu	Bacteria;Bacteroidetes;Bacteroidia;Sphingobacteriales;Sphingobacteriaceae;Sphingobacterium
Bacteria;Chlamydiae;Chlamydiae;Chlamydiales;Chlamydiaceae;Chlamydia;Anolis_carolinensis_(green_anole)	Bacteria;Chlamydiae;Chlamydiae;Chlamydiales;Chlamydiaceae;Chlamydia
Bacteria;Chlamydiae;Chlamydiae;Chlamydiales;Simkaniaceae;Candidatus_Rhabdochlamydia;Latrodectus_geometricus_(brown_widow)	Bacteria;Chlamydiae;Chlamydiae;Chlamydiales;Simkaniaceae;Candidatus_Rhabdochlamydia
Bacteria;Chlamydiae;Chlamydiae;Chlamydiales;Simkaniaceae;Candidatus_Rhabdochlamydia;Tetrodontophora_bielanensis_(giant_springtail)	Bacteria;Chlamydiae;Chlamydiae;Chlamydiales;Simkaniaceae;Candidatus_Rhabdochlamydia
Bacteria;Cyanobacteria;Melainabacteria;Gastranaerophilales;Blattella_germanica_(German_cockroach)	Bacteria;Cyanobacteria;Melainabacteria;Gastranaerophilales
Bacteria;Cyanobacteria;Oxyphotobacteria;Chloroplast;Cladosiphon_okamuranus	Bacteria;Cyanobacteria;Oxyphotobacteria;Chloroplast
Bacteria;Cyanobacteria;Oxyphotobacteria;Chloroplast;Ephemera_danica	Bacteria;Cyanobacteria;Oxyphotobacteria;Chloroplast
Bacteria;Cyanobacteria;Oxyphotobacteria;Chloroplast;Porites_astreoides	Bacteria;Cyanobacteria;Oxyphotobacteria;Chloroplast;;
Bacteria;Cyanobacteria;Oxyphotobacteria;Nostocales;Chroococcidiopsaceae;Aliterella_CENA595;Oreochromis_niloticus_(Nile_tilapia)	Bacteria;Cyanobacteria;Oxyphotobacteria;Nostocales;Chroococcidiopsaceae;Aliterella_CENA595
Bacteria;Cyanobacteria;Oxyphotobacteria;Nostocales;Chroococcidiopsaceae;Chroococcidiopsis_SAG_2023;Larimichthys_crocea_(large_yellow_croaker)	Bacteria;Cyanobacteria;Oxyphotobacteria;Nostocales;Chroococcidiopsaceae;Chroococcidiopsis_SAG_2023
Bacteria;Cyanobacteria;Oxyphotobacteria;Nostocales;Coleofasciculaceae;Microcoleus_SAG_1449-1a;Persicaria_minor	Bacteria;Cyanobacteria;Oxyphotobacteria;Nostocales;Coleofasciculaceae;Microcoleus;SAG_1449-1a
Bacteria;Deferribacteres;Deferribacteres;Deferribacterales;Deferribacteraceae;Mucispirillum;Gadus_morhua_(Atlantic_cod)	Bacteria;Deferribacteres;Deferribacteres;Deferribacterales;Deferribacteraceae;Mucispirillum
Bacteria;Deinococcus-Thermus;Deinococci;Deinococcales;Deinococcaceae;Deinococcus;Cenchrus_americanus	Bacteria;Deinococcus-Thermus;Deinococci;Deinococcales;Deinococcaceae;Deinococcus
Bacteria;Deinococcus-Thermus;Deinococci;Deinococcales;Deinococcaceae;Deinococcus;Methylobacterium_adhaesivum	Bacteria;Deinococcus-Thermus;Deinococci;Deinococcales;Deinococcaceae;Deinococcus
Bacteria;Epsilonbacteraeota;Campylobacteria;Campylobacterales;Helicobacteraceae;Helicobacter;Syphacia_muris	Bacteria;Epsilonbacteraeota;Campylobacteria;Campylobacterales;Helicobacteraceae;Helicobacter
Bacteria;Epsilonbacteraeota;Campylobacteria;Campylobacterales;Sulfurovaceae;Sulfurovum;Alviniconcha_aff._hessleri_gill_endosymbiont	Bacteria;Epsilonbacteraeota;Campylobacteria;Campylobacterales;Sulfurovaceae;Sulfurovum
Bacteria;Epsilonbacteraeota;Campylobacteria;Campylobacterales;Thiovulaceae;Sulfurimonas;Alviniconcha_sp._gill_symbiont	Bacteria;Epsilonbacteraeota;Campylobacteria;Campylobacterales;Thiovulaceae;Sulfurimonas
Bacteria;Firmicutes;Bacilli;Bacillales;Paenibacillaceae;Brevibacillus;Xanthomonas_arboricola_pv._juglandis	Bacteria;Firmicutes;Bacilli;Bacillales;Paenibacillaceae;Brevibacillus
Bacteria;Firmicutes;Bacilli;Bacillales;Paenibacillaceae;Paenibacillus;Azotobacter_vinelandii	Bacteria;Firmicutes;Bacilli;Bacillales;Paenibacillaceae;Paenibacillus
Bacteria;Firmicutes;Bacilli;Bacillales;Paenibacillaceae;Paenibacillus;Caenorhabditis_brenneri	Bacteria;Firmicutes;Bacilli;Bacillales;Paenibacillaceae;Paenibacillus
Bacteria;Firmicutes;Bacilli;Bacillales;Paenibacillaceae;Paenibacillus;Chlamydia_abortus	Bacteria;Firmicutes;Bacilli;Bacillales;Paenibacillaceae;Paenibacillus
Bacteria;Firmicutes;Bacilli;Bacillales;Paenibacillaceae;Paenibacillus;Escherichia_sp._BAB-3431	Bacteria;Firmicutes;Bacilli;Bacillales;Paenibacillaceae;Paenibacillus
Bacteria;Firmicutes;Bacilli;Bacillales;Paenibacillaceae;Paenibacillus;Firmicutes_bacterium_rif200828	Bacteria;Firmicutes;Bacilli;Bacillales;Paenibacillaceae;Paenibacillus
Bacteria;Firmicutes;Bacilli;Bacillales;Paenibacillaceae;Paenibacillus;Firmicutes_bacterium_SM22	Bacteria;Firmicutes;Bacilli;Bacillales;Paenibacillaceae;Paenibacillus
Bacteria;Firmicutes;Bacilli;Bacillales;Paenibacillaceae;Paenibacillus;Firmicutes_bacterium_SM60	Bacteria;Firmicutes;Bacilli;Bacillales;Paenibacillaceae;Paenibacillus
Bacteria;Firmicutes;Bacilli;Bacillales;Paenibacillaceae;Paenibacillus;Fontibacillus_panacisegetis	Bacteria;Firmicutes;Bacilli;Bacillales;Paenibacillaceae;Paenibacillus
Bacteria;Firmicutes;Bacilli;Bacillales;Paenibacillaceae;Paenibacillus;Fontibacillus_phaseoli	Bacteria;Firmicutes;Bacilli;Bacillales;Paenibacillaceae;Paenibacillus
Bacteria;Firmicutes;Bacilli;Bacillales;Paenibacillaceae;Paenibacillus;Fontibacillus_solani	Bacteria;Firmicutes;Bacilli;Bacillales;Paenibacillaceae;Paenibacillus
Bacteria;Firmicutes;Bacilli;Bacillales;Paenibacillaceae;Paenibacillus;Geobacillus_sp._JNTUH4	Bacteria;Firmicutes;Bacilli;Bacillales;Paenibacillaceae;Paenibacillus
Bacteria;Firmicutes;Bacilli;Bacillales;Paenibacillaceae;Paenibacillus;Mannheimia_haemolytica_MhBrain2012	Bacteria;Firmicutes;Bacilli;Bacillales;Paenibacillaceae;Paenibacillus
Bacteria;Firmicutes;Bacilli;Bacillales;Paenibacillaceae;Paenibacillus;Microbotryum_violaceum	Bacteria;Firmicutes;Bacilli;Bacillales;Paenibacillaceae;Paenibacillus
Bacteria;Firmicutes;Bacilli;Bacillales;Paenibacillaceae;Paenibacillus;Mucor_ambiguus	Bacteria;Firmicutes;Bacilli;Bacillales;Paenibacillaceae;Paenibacillus
Bacteria;Firmicutes;Bacilli;Bacillales;Paenibacillaceae;Paenibacillus;Mycobacterium_sp._DWMJ-2018B1	Bacteria;Firmicutes;Bacilli;Bacillales;Paenibacillaceae;Paenibacillus
Bacteria;Firmicutes;Bacilli;Bacillales;Paenibacillaceae;Paenibacillus;Mycobacterium_sp._DWMJ-2018B2	Bacteria;Firmicutes;Bacilli;Bacillales;Paenibacillaceae;Paenibacillus
Bacteria;Firmicutes;Bacilli;Bacillales;Paenibacillaceae;Paenibacillus;Mycobacterium_sp._DWMJ-2018B3	Bacteria;Firmicutes;Bacilli;Bacillales;Paenibacillaceae;Paenibacillus
Bacteria;Firmicutes;Bacilli;Bacillales;Paenibacillaceae;Paenibacillus;Mycobacterium_sp._DWMJ-443B1	Bacteria;Firmicutes;Bacilli;Bacillales;Paenibacillaceae;Paenibacillus
Bacteria;Firmicutes;Bacilli;Bacillales;Paenibacillaceae;Paenibacillus;Mycobacterium_sp._DWMJ-515A1	Bacteria;Firmicutes;Bacilli;Bacillales;Paenibacillaceae;Paenibacillus
Bacteria;Firmicutes;Bacilli;Bacillales;Paenibacillaceae;Paenibacillus;Mycobacterium_tuberculosis	Bacteria;Firmicutes;Bacilli;Bacillales;Paenibacillaceae;Paenibacillus
Bacteria;Firmicutes;Bacilli;Bacillales;Paenibacillaceae;Paenibacillus;Mycobacterium_tuberculosis_FJ05194	Bacteria;Firmicutes;Bacilli;Bacillales;Paenibacillaceae;Paenibacillus
Bacteria;Firmicutes;Bacilli;Bacillales;Paenibacillaceae;Paenibacillus;Oryza_sativa_Indica_Group_(long-grained_rice)	Bacteria;Firmicutes;Bacilli;Bacillales;Paenibacillaceae;Paenibacillus
Bacteria;Firmicutes;Bacilli;Bacillales;Paenibacillaceae;Paenibacillus;P-decomposing_bacterium_1	Bacteria;Firmicutes;Bacilli;Bacillales;Paenibacillaceae;Paenibacillus
Bacteria;Firmicutes;Bacilli;Bacillales;Paenibacillaceae;Paenibacillus;Pantoea_agglomerans	Bacteria;Firmicutes;Bacilli;Bacillales;Paenibacillaceae;Paenibacillus
Bacteria;Firmicutes;Bacilli;Bacillales;Paenibacillaceae;Paenibacillus;Pseudomonas_fluorescens	Bacteria;Firmicutes;Bacilli;Bacillales;Paenibacillaceae;Paenibacillus
Bacteria;Firmicutes;Bacilli;Bacillales;Paenibacillaceae;Paenibacillus;Pseudomonas_sp._CL4.14	Bacteria;Firmicutes;Bacilli;Bacillales;Paenibacillaceae;Paenibacillus
Bacteria;Firmicutes;Bacilli;Bacillales;Paenibacillaceae;Paenibacillus;Rhizobium_sp._rf002	Bacteria;Firmicutes;Bacilli;Bacillales;Paenibacillaceae;Paenibacillus
Bacteria;Firmicutes;Bacilli;Bacillales;Paenibacillaceae;Paenibacillus;Siboglinum_sp._associated_bacterium	Bacteria;Firmicutes;Bacilli;Bacillales;Paenibacillaceae;Paenibacillus
Bacteria;Firmicutes;Bacilli;Bacillales;Paenibacillaceae;Paenibacillus;Streptococcus_pneumoniae	Bacteria;Firmicutes;Bacilli;Bacillales;Paenibacillaceae;Paenibacillus
Bacteria;Firmicutes;Bacilli;Bacillales;Paenibacillaceae;Paenibacillus;Streptomyces_sp._KP17	Bacteria;Firmicutes;Bacilli;Bacillales;Paenibacillaceae;Paenibacillus
Bacteria;Firmicutes;Bacilli;Bacillales;Paenibacillaceae;Paenibacillus;Trachelomonas_grandis	Bacteria;Firmicutes;Bacilli;Bacillales;Paenibacillaceae;Paenibacillus
Bacteria;Firmicutes;Bacilli;Bacillales;Paenibacillaceae;Paenibacillus;Triticum_aestivum_(bread_wheat)	Bacteria;Firmicutes;Bacilli;Bacillales;Paenibacillaceae;Paenibacillus
Bacteria;Firmicutes;Bacilli;Bacillales;Planococcaceae;Kurthia;Proteus_vulgaris	Bacteria;Firmicutes;Bacilli;Bacillales;Planococcaceae;Kurthia
Bacteria;Firmicutes;Bacilli;Bacillales;Planococcaceae;Lysinibacillus;Staphylococcus;RCSR-NCCS-ST1	Bacteria;Firmicutes;Bacilli;Bacillales;Planococcaceae;Lysinibacillus
Bacteria;Firmicutes;Bacilli;Bacillales;Planococcaceae;Planomicrobium;Pseudomonas_xanthomarina	Bacteria;Firmicutes;Bacilli;Bacillales;Planococcaceae;Planomicrobium
Bacteria;Firmicutes;Bacilli;Bacillales;Staphylococcaceae;Staphylococcus;[Bacillus];KITNT-3	Bacteria;Firmicutes;Bacilli;Bacillales;Staphylococcaceae;Staphylococcus
Bacteria;Firmicutes;Bacilli;Bacillales;Staphylococcaceae;Staphylococcus;Barnesiella;S345	Bacteria;Firmicutes;Bacilli;Bacillales;Staphylococcaceae;Staphylococcus
Bacteria;Firmicutes;Bacilli;Bacillales;Staphylococcaceae;Staphylococcus;Brevibacterium;ESC-str.590	Bacteria;Firmicutes;Bacilli;Bacillales;Staphylococcaceae;Staphylococcus
Bacteria;Firmicutes;Bacilli;Bacillales;Staphylococcaceae;Staphylococcus;Clostridioides_difficile	Bacteria;Firmicutes;Bacilli;Bacillales;Staphylococcaceae;Staphylococcus
Bacteria;Firmicutes;Bacilli;Bacillales;Staphylococcaceae;Staphylococcus;Corynebacterium_diphtheriae	Bacteria;Firmicutes;Bacilli;Bacillales;Staphylococcaceae;Staphylococcus
Bacteria;Firmicutes;Bacilli;Bacillales;Staphylococcaceae;Staphylococcus;Coturnix_japonica_(Japanese_quail)	Bacteria;Firmicutes;Bacilli;Bacillales;Staphylococcaceae;Staphylococcus
Bacteria;Firmicutes;Bacilli;Bacillales;Staphylococcaceae;Staphylococcus;Enterobacter;IF2SW-B1	Bacteria;Firmicutes;Bacilli;Bacillales;Staphylococcaceae;Staphylococcus
Bacteria;Firmicutes;Bacilli;Bacillales;Staphylococcaceae;Staphylococcus;Lactobacillus_pentosus	Bacteria;Firmicutes;Bacilli;Bacillales;Staphylococcaceae;Staphylococcus
Bacteria;Firmicutes;Bacilli;Bacillales;Staphylococcaceae;Staphylococcus;Listeria_monocytogenes	Bacteria;Firmicutes;Bacilli;Bacillales;Staphylococcaceae;Staphylococcus
Bacteria;Firmicutes;Bacilli;Bacillales;Staphylococcaceae;Staphylococcus;Planomicrobium_okeanokoites	Bacteria;Firmicutes;Bacilli;Bacillales;Staphylococcaceae;Staphylococcus
Bacteria;Firmicutes;Bacilli;Bacillales;Staphylococcaceae;Staphylococcus;Pseudomonas;TB23	Bacteria;Firmicutes;Bacilli;Bacillales;Staphylococcaceae;Staphylococcus
Bacteria;Firmicutes;Bacilli;Bacillales;Staphylococcaceae;Staphylococcus;Salmonella_enterica	Bacteria;Firmicutes;Bacilli;Bacillales;Staphylococcaceae;Staphylococcus
Bacteria;Firmicutes;Bacilli;Bacillales;Staphylococcaceae;Staphylococcus;Spirochaeta;	Bacteria;Firmicutes;Bacilli;Bacillales;Staphylococcaceae;Staphylococcus
Bacteria;Firmicutes;Bacilli;Bacillales;Staphylococcaceae;Staphylococcus;Streptococcus_pneumoniae	Bacteria;Firmicutes;Bacilli;Bacillales;Staphylococcaceae;Staphylococcus
Bacteria;Firmicutes;Bacilli;Bacillales;Staphylococcaceae;Staphylococcus;Streptococcus;ChDC_B377	Bacteria;Firmicutes;Bacilli;Bacillales;Staphylococcaceae;Staphylococcus
Bacteria;Firmicutes;Bacilli;Bacillales;Staphylococcaceae;Staphylococcus;Streptomyces_brasiliensis	Bacteria;Firmicutes;Bacilli;Bacillales;Staphylococcaceae;Staphylococcus
Bacteria;Firmicutes;Bacilli;Bacillales;Staphylococcaceae;Staphylococcus;Streptomyces_canus	Bacteria;Firmicutes;Bacilli;Bacillales;Staphylococcaceae;Staphylococcus
Bacteria;Firmicutes;Bacilli;Lactobacillales;Carnobacteriaceae;Desemzia;Mycobacterium_abscessus_subsp._abscessus	Bacteria;Firmicutes;Bacilli;Lactobacillales;Carnobacteriaceae;Desemzia
Bacteria;Firmicutes;Bacilli;Lactobacillales;Carnobacteriaceae;Desemzia;Staphylococcus_aureus	Bacteria;Firmicutes;Bacilli;Lactobacillales;Carnobacteriaceae;Desemzia
Bacteria;Firmicutes;Bacilli;Lactobacillales;Carnobacteriaceae;Granulicatella;Enterobacter_cloacae	Bacteria;Firmicutes;Bacilli;Lactobacillales;Carnobacteriaceae;Granulicatella
Bacteria;Firmicutes;Bacilli;Lactobacillales;Enterococcaceae;Enterococcus;Acinetobacter;25977_7	Bacteria;Firmicutes;Bacilli;Lactobacillales;Enterococcaceae;Enterococcus
Bacteria;Firmicutes;Bacilli;Lactobacillales;Enterococcaceae;Enterococcus;Lactococcus_lactis;lactis	Bacteria;Firmicutes;Bacilli;Lactobacillales;Enterococcaceae;Enterococcus
Bacteria;Firmicutes;Bacilli;Lactobacillales;Enterococcaceae;Enterococcus;Leuconostoc_mesenteroides	Bacteria;Firmicutes;Bacilli;Lactobacillales;Enterococcaceae;Enterococcus
Bacteria;Firmicutes;Bacilli;Lactobacillales;Enterococcaceae;Enterococcus;Listeria_grayi	Bacteria;Firmicutes;Bacilli;Lactobacillales;Enterococcaceae;Enterococcus
Bacteria;Firmicutes;Bacilli;Lactobacillales;Enterococcaceae;Enterococcus;Listeria_innocua	Bacteria;Firmicutes;Bacilli;Lactobacillales;Enterococcaceae;Enterococcus
Bacteria;Firmicutes;Bacilli;Lactobacillales;Enterococcaceae;Enterococcus;Sphaeropthalma_orestes	Bacteria;Firmicutes;Bacilli;Lactobacillales;Enterococcaceae;Enterococcus
Bacteria;Firmicutes;Bacilli;Lactobacillales;Enterococcaceae;Enterococcus;Streptomyces_cinnamoneus	Bacteria;Firmicutes;Bacilli;Lactobacillales;Enterococcaceae;Enterococcus
Bacteria;Firmicutes;Bacilli;Lactobacillales;Lactobacillaceae;Lactobacillus;Apis_florea_(little_honeybee)	Bacteria;Firmicutes;Bacilli;Lactobacillales;Lactobacillaceae;Lactobacillus
Bacteria;Firmicutes;Bacilli;Lactobacillales;Lactobacillaceae;Lactobacillus;Blaberus_atropos	Bacteria;Firmicutes;Bacilli;Lactobacillales;Lactobacillaceae;Lactobacillus
Bacteria;Firmicutes;Bacilli;Lactobacillales;Lactobacillaceae;Lactobacillus;Chlamydia_trachomatis	Bacteria;Firmicutes;Bacilli;Lactobacillales;Lactobacillaceae;Lactobacillus
Bacteria;Firmicutes;Bacilli;Lactobacillales;Lactobacillaceae;Lactobacillus;Drosophila_kikkawai	Bacteria;Firmicutes;Bacilli;Lactobacillales;Lactobacillaceae;Lactobacillus
Bacteria;Firmicutes;Bacilli;Lactobacillales;Lactobacillaceae;Lactobacillus;Enterococcus_durans	Bacteria;Firmicutes;Bacilli;Lactobacillales;Lactobacillaceae;Lactobacillus
Bacteria;Firmicutes;Bacilli;Lactobacillales;Lactobacillaceae;Lactobacillus;Enterococcus_faecium	Bacteria;Firmicutes;Bacilli;Lactobacillales;Lactobacillaceae;Lactobacillus
Bacteria;Firmicutes;Bacilli;Lactobacillales;Lactobacillaceae;Lactobacillus;Megalopta_genalis	Bacteria;Firmicutes;Bacilli;Lactobacillales;Lactobacillaceae;Lactobacillus
Bacteria;Firmicutes;Bacilli;Lactobacillales;Leuconostocaceae;Weissella;Staphylococcus	Bacteria;Firmicutes;Bacilli;Lactobacillales;Leuconostocaceae;Weissella
Bacteria;Firmicutes;Bacilli;Lactobacillales;Streptococcaceae;Streptococcus;Coregonus_clupeaformis_(lake_whitefish)	Bacteria;Firmicutes;Bacilli;Lactobacillales;Streptococcaceae;Streptococcus
Bacteria;Firmicutes;Bacilli;Lactobacillales;Streptococcaceae;Streptococcus;Trichuris_trichiura_(human_whipworm)	Bacteria;Firmicutes;Bacilli;Lactobacillales;Streptococcaceae;Streptococcus
Bacteria;Firmicutes;Clostridia;Clostridiales;Christensenellaceae;Christensenellaceae_R-7_group;Blattella_germanica_(German_cockroach)	Bacteria;Firmicutes;Clostridia;Clostridiales;Christensenellaceae;Christensenellaceae_R-7_group
Bacteria;Firmicutes;Clostridia;Clostridiales;Family_XI;Anaerococcus;Chlamydia_trachomatis	Bacteria;Firmicutes;Clostridia;Clostridiales;Family_XI;Anaerococcus
Bacteria;Firmicutes;Clostridia;Clostridiales;Family_XI;Anaerococcus;Peptoniphilus_asaccharolyticus	Bacteria;Firmicutes;Clostridia;Clostridiales;Family_XI;Anaerococcus
Bacteria;Firmicutes;Clostridia;Clostridiales;Family_XI;Peptoniphilus;Anaerococcus_prevotii	Bacteria;Firmicutes;Clostridia;Clostridiales;Family_XI;Peptoniphilus
Bacteria;Firmicutes;Clostridia;Clostridiales;Family_XI;Tissierella;Varibaculum_timonense	Bacteria;Firmicutes;Clostridia;Clostridiales;Family_XI;Tissierella
Bacteria;Firmicutes;Clostridia;Clostridiales;Family_XIII;Anaerovorax;Ephemera_danica	Bacteria;Firmicutes;Clostridia;Clostridiales;Family_XIII;Anaerovorax
Bacteria;Firmicutes;Clostridia;Clostridiales;Lachnospiraceae;Anaerosporobacter;Blattella_germanica_(German_cockroach)	Bacteria;Firmicutes;Clostridia;Clostridiales;Lachnospiraceae;Anaerosporobacter
Bacteria;Firmicutes;Clostridia;Clostridiales;Lachnospiraceae;Incertae_Sedis;Blattella_germanica_(German_cockroach)	Bacteria;Firmicutes;Clostridia;Clostridiales;Lachnospiraceae;Incertae_Sedis
Bacteria;Firmicutes;Clostridia;Clostridiales;Lachnospiraceae;Lachnoclostridium;Coptotermes_gestroi	Bacteria;Firmicutes;Clostridia;Clostridiales;Lachnospiraceae;Lachnoclostridium
Bacteria;Firmicutes;Clostridia;Clostridiales;Lachnospiraceae;Roseburia;Blattella_germanica_(German_cockroach)	Bacteria;Firmicutes;Clostridia;Clostridiales;Lachnospiraceae;Roseburia
Bacteria;Firmicutes;Clostridia;Clostridiales;Lachnospiraceae;Tyzzerella_3;Blattella_germanica_(German_cockroach)	Bacteria;Firmicutes;Clostridia;Clostridiales;Lachnospiraceae;Tyzzerella_3
Bacteria;Firmicutes;Clostridia;Clostridiales;Lachnospiraceae;Tyzzerella;Gadus_morhua_(Atlantic_cod)	Bacteria;Firmicutes;Clostridia;Clostridiales;Lachnospiraceae;Tyzzerella
Bacteria;Firmicutes;Clostridia;Clostridiales;Lachnospiraceae;uncultured;Coptotermes_gestroi	Bacteria;Firmicutes;Clostridia;Clostridiales;Lachnospiraceae;
Bacteria;Firmicutes;Clostridia;Clostridiales;Ruminococcaceae;Candidatus_Soleaferrea;Coptotermes_gestroi	Bacteria;Firmicutes;Clostridia;Clostridiales;Ruminococcaceae;Candidatus_Soleaferrea
Bacteria;Firmicutes;Clostridia;Clostridiales;Ruminococcaceae;Faecalibacterium;Trichuris_trichiura_(human_whipworm)	Bacteria;Firmicutes;Clostridia;Clostridiales;Ruminococcaceae;Faecalibacterium
Bacteria;Firmicutes;Clostridia;Clostridiales;Ruminococcaceae;Hydrogenoanaerobacterium;Blattella_germanica_(German_cockroach)	Bacteria;Firmicutes;Clostridia;Clostridiales;Ruminococcaceae;Hydrogenoanaerobacterium
Bacteria;Firmicutes;Clostridia;Clostridiales;Ruminococcaceae;Hydrogenoanaerobacterium;Gadus_morhua_(Atlantic_cod)	Bacteria;Firmicutes;Clostridia;Clostridiales;Ruminococcaceae;Hydrogenoanaerobacterium
Bacteria;Firmicutes;Clostridia;Clostridiales;Ruminococcaceae;Ruminococcaceae_UCG-002;Trichuris_trichiura_(human_whipworm)	Bacteria;Firmicutes;Clostridia;Clostridiales;Ruminococcaceae;Ruminococcaceae_UCG-002
Bacteria;Firmicutes;Erysipelotrichia;Erysipelotrichales;Erysipelotrichaceae;Catenisphaera;Chlamydia_trachomatis	Bacteria;Firmicutes;Erysipelotrichia;Erysipelotrichales;Erysipelotrichaceae;Catenisphaera
Bacteria;Firmicutes;Negativicutes;Selenomonadales;Veillonellaceae;Dialister;Bacteroides_xylanisolvens	Bacteria;Firmicutes;Negativicutes;Selenomonadales;Veillonellaceae;Dialister
Bacteria;Firmicutes;Negativicutes;Selenomonadales;Veillonellaceae;Megasphaera;Lactobacillus_sp._AB032	Bacteria;Firmicutes;Negativicutes;Selenomonadales;Veillonellaceae;Megasphaera
Bacteria;Fusobacteria;Fusobacteriia;Fusobacteriales;Fusobacteriaceae;Cetobacterium;Oryzias_latipes_(Japanese_medaka)	Bacteria;Fusobacteria;Fusobacteriia;Fusobacteriales;Fusobacteriaceae;Cetobacterium
Bacteria;Fusobacteria;Fusobacteriia;Fusobacteriales;Fusobacteriaceae;Fusobacterium;[Clostridium]_rectum	Bacteria;Fusobacteria;Fusobacteriia;Fusobacteriales;Fusobacteriaceae;Fusobacterium
Bacteria;Fusobacteria;Fusobacteriia;Fusobacteriales;Fusobacteriaceae;Fusobacterium;Filifactor_alocis	Bacteria;Fusobacteria;Fusobacteriia;Fusobacteriales;Fusobacteriaceae;Fusobacterium
Bacteria;Planctomycetes;Phycisphaerae;Phycisphaerales;Phycisphaeraceae;SM1A02;Gambierdiscus_polynesiensis	Bacteria;Planctomycetes;Phycisphaerae;Phycisphaerales;Phycisphaeraceae;SM1A02
Bacteria;Planctomycetes;Phycisphaerae;Phycisphaerales;Phycisphaeraceae;SM1A02;Nannochloropsis_gaditana	Bacteria;Planctomycetes;Phycisphaerae;Phycisphaerales;Phycisphaeraceae;SM1A02
Bacteria;Planctomycetes;Planctomycetacia;Gemmatales;Gemmataceae;Zavarzinella;Cymbella_subturgidula	Bacteria;Planctomycetes;Planctomycetacia;Gemmatales;Gemmataceae;Zavarzinella
Bacteria;Planctomycetes;Planctomycetacia;Pirellulales;Pirellulaceae;Rhodopirellula;Tigriopus_californicus	Bacteria;Planctomycetes;Planctomycetacia;Pirellulales;Pirellulaceae;Rhodopirellula
Bacteria;Planctomycetes;Planctomycetacia;Pirellulales;Pirellulaceae;Termite_planctomycete_cluster;Mastotermes_darwiniensis_(giant_northern_termite)	Bacteria;Planctomycetes;Planctomycetacia;Pirellulales;Pirellulaceae;Termite_planctomycete_cluster
Bacteria;Proteobacteria;Alphaproteobacteria;Acetobacterales;Acetobacteraceae;Acetobacter;Drosophila_serrata	Bacteria;Proteobacteria;Alphaproteobacteria;Acetobacterales;Acetobacteraceae;Acetobacter
Bacteria;Proteobacteria;Alphaproteobacteria;Acetobacterales;Acetobacteraceae;Acetobacter;Drosophila_simulans	Bacteria;Proteobacteria;Alphaproteobacteria;Acetobacterales;Acetobacteraceae;Acetobacter
Bacteria;Proteobacteria;Alphaproteobacteria;Acetobacterales;Acetobacteraceae;Commensalibacter;Apis_mellifera_(honey_bee)	Bacteria;Proteobacteria;Alphaproteobacteria;Acetobacterales;Acetobacteraceae;Commensalibacter
Bacteria;Proteobacteria;Alphaproteobacteria;Azospirillales;Azospirillaceae;Azospirillum;Corchorus_olitorius	Bacteria;Proteobacteria;Alphaproteobacteria;Azospirillales;Azospirillaceae;Azospirillum
Bacteria;Proteobacteria;Alphaproteobacteria;Caulobacterales;Caulobacteraceae;Brevundimonas;Arthrobacter_sp._PG5-MRL	Bacteria;Proteobacteria;Alphaproteobacteria;Caulobacterales;Caulobacteraceae;Brevundimonas
Bacteria;Proteobacteria;Alphaproteobacteria;Caulobacterales;Caulobacteraceae;Brevundimonas;Burkholderia_sp._HOT13	Bacteria;Proteobacteria;Alphaproteobacteria;Caulobacterales;Caulobacteraceae;Brevundimonas
Bacteria;Proteobacteria;Alphaproteobacteria;Caulobacterales;Caulobacteraceae;Brevundimonas;Dactylopius_coccus	Bacteria;Proteobacteria;Alphaproteobacteria;Caulobacterales;Caulobacteraceae;Brevundimonas
Bacteria;Proteobacteria;Alphaproteobacteria;Caulobacterales;Caulobacteraceae;Brevundimonas;Nannochloropsis_oceanica	Bacteria;Proteobacteria;Alphaproteobacteria;Caulobacterales;Caulobacteraceae;Brevundimonas
Bacteria;Proteobacteria;Alphaproteobacteria;Caulobacterales;Hyphomonadaceae;uncultured;Cladosiphon_okamuranus	Bacteria;Proteobacteria;Alphaproteobacteria;Caulobacterales;Hyphomonadaceae;
Bacteria;Proteobacteria;Alphaproteobacteria;Parvibaculales;uncultured;Saccharina_japonica	Bacteria;Proteobacteria;Alphaproteobacteria;Parvibaculales;;
Bacteria;Proteobacteria;Alphaproteobacteria;Rhizobiales;Beijerinckiaceae;Microvirga;Deinococcus_sp._4A6	Bacteria;Proteobacteria;Alphaproteobacteria;Rhizobiales;Beijerinckiaceae;Microvirga
Bacteria;Proteobacteria;Alphaproteobacteria;Rhizobiales;Beijerinckiaceae;Microvirga;Deinococcus_sp._4B4	Bacteria;Proteobacteria;Alphaproteobacteria;Rhizobiales;Beijerinckiaceae;Microvirga
Bacteria;Proteobacteria;Alphaproteobacteria;Rhizobiales;Beijerinckiaceae;Microvirga;Deinococcus_sp._5A4	Bacteria;Proteobacteria;Alphaproteobacteria;Rhizobiales;Beijerinckiaceae;Microvirga
Bacteria;Proteobacteria;Alphaproteobacteria;Rhizobiales;Beijerinckiaceae;Microvirga;Deinococcus_sp._UAC-61	Bacteria;Proteobacteria;Alphaproteobacteria;Rhizobiales;Beijerinckiaceae;Microvirga
Bacteria;Proteobacteria;Alphaproteobacteria;Rhizobiales;Rhizobiaceae;Allorhizobium-Neorhizobium-Pararhizobium-Rhizobium;Danio_rerio_(zebrafish)	Bacteria;Proteobacteria;Alphaproteobacteria;Rhizobiales;Rhizobiaceae;Allorhizobium-Neorhizobium-Pararhizobium-Rhizobium
Bacteria;Proteobacteria;Alphaproteobacteria;Rhizobiales;Rhizobiaceae;Candidatus_Hodgkinia;Okanagana_villosa	Bacteria;Proteobacteria;Alphaproteobacteria;Rhizobiales;Rhizobiaceae;Candidatus_Hodgkinia
Bacteria;Proteobacteria;Alphaproteobacteria;Rhizobiales;Rhizobiaceae;Ochrobactrum;Flavobacterium_sp._SL122	Bacteria;Proteobacteria;Alphaproteobacteria;Rhizobiales;Rhizobiaceae;Ochrobactrum
Bacteria;Proteobacteria;Alphaproteobacteria;Rhizobiales;Rhizobiaceae;Ochrobactrum;Klebsiella_sp._enrichment_culture_clone_9.2.1.1	Bacteria;Proteobacteria;Alphaproteobacteria;Rhizobiales;Rhizobiaceae;Ochrobactrum
Bacteria;Proteobacteria;Alphaproteobacteria;Rhizobiales;Rhizobiaceae;Phyllobacterium;Acytostelium_leptosomum	Bacteria;Proteobacteria;Alphaproteobacteria;Rhizobiales;Rhizobiaceae;Phyllobacterium
Bacteria;Proteobacteria;Alphaproteobacteria;Rhizobiales;Rhizobiaceae;Phyllobacterium;Dictyostelium_deminutivum	Bacteria;Proteobacteria;Alphaproteobacteria;Rhizobiales;Rhizobiaceae;Phyllobacterium
Bacteria;Proteobacteria;Alphaproteobacteria;Rhizobiales;Rhizobiaceae;Phyllobacterium;Paenibacillus_sophorae	Bacteria;Proteobacteria;Alphaproteobacteria;Rhizobiales;Rhizobiaceae;Phyllobacterium
Bacteria;Proteobacteria;Alphaproteobacteria;Rhizobiales;Stappiaceae;Labrenzia;Cladosiphon_okamuranus	Bacteria;Proteobacteria;Alphaproteobacteria;Rhizobiales;Stappiaceae;Labrenzia
Bacteria;Proteobacteria;Alphaproteobacteria;Rhizobiales;Stappiaceae;Pannonibacter;Achromobacter_sp._HT18	Bacteria;Proteobacteria;Alphaproteobacteria;Rhizobiales;Stappiaceae;Pannonibacter
Bacteria;Proteobacteria;Alphaproteobacteria;Rhizobiales;Xanthobacteraceae;Bradyrhizobium;Branchiostoma_floridae_(Florida_lancelet)	Bacteria;Proteobacteria;Alphaproteobacteria;Rhizobiales;Xanthobacteraceae;Bradyrhizobium
Bacteria;Proteobacteria;Alphaproteobacteria;Rhodobacterales;Rhodobacteraceae;Oceanobacterium;Alphaproteobacteria_sp._MG35	Bacteria;Proteobacteria;Alphaproteobacteria;Rhodobacterales;Rhodobacteraceae;Oceanobacterium
Bacteria;Proteobacteria;Alphaproteobacteria;Rhodobacterales;Rhodobacteraceae;Paracoccus;Acanthamoeba_polyphaga	Bacteria;Proteobacteria;Alphaproteobacteria;Rhodobacterales;Rhodobacteraceae;Paracoccus
Bacteria;Proteobacteria;Alphaproteobacteria;Rhodobacterales;Rhodobacteraceae;Paracoccus;Amia_calva_(bowfin)	Bacteria;Proteobacteria;Alphaproteobacteria;Rhodobacterales;Rhodobacteraceae;Paracoccus
Bacteria;Proteobacteria;Alphaproteobacteria;Rhodobacterales;Rhodobacteraceae;Rhodobacter;Reticulomyxa_filosa	Bacteria;Proteobacteria;Alphaproteobacteria;Rhodobacterales;Rhodobacteraceae;Rhodobacter
Bacteria;Proteobacteria;Alphaproteobacteria;Rhodospirillales;Magnetospiraceae;uncultured;Saccharina_japonica	Bacteria;Proteobacteria;Alphaproteobacteria;Rhodospirillales;Magnetospiraceae;
Bacteria;Proteobacteria;Alphaproteobacteria;Rhodovibrionales;Kiloniellaceae;Tistlia;Brucella_sp._HJ114	Bacteria;Proteobacteria;Alphaproteobacteria;Rhodovibrionales;Kiloniellaceae;Tistlia
Bacteria;Proteobacteria;Alphaproteobacteria;Rhodovibrionales;Kiloniellaceae;Tistlia;Nitratireductor_sp._H19-05	Bacteria;Proteobacteria;Alphaproteobacteria;Rhodovibrionales;Kiloniellaceae;Tistlia
Bacteria;Proteobacteria;Alphaproteobacteria;Rickettsiales;Anaplasmataceae;Wolbachia;Armadillidium_vulgare_(common_pillbug)	Bacteria;Proteobacteria;Alphaproteobacteria;Rickettsiales;Anaplasmataceae;Wolbachia
Bacteria;Proteobacteria;Alphaproteobacteria;Rickettsiales;Anaplasmataceae;Wolbachia;Calligrapha_confluens	Bacteria;Proteobacteria;Alphaproteobacteria;Rickettsiales;Anaplasmataceae;Wolbachia
Bacteria;Proteobacteria;Alphaproteobacteria;Rickettsiales;Anaplasmataceae;Wolbachia;Coptotermes_gestroi	Bacteria;Proteobacteria;Alphaproteobacteria;Rickettsiales;Anaplasmataceae;Wolbachia
Bacteria;Proteobacteria;Alphaproteobacteria;Rickettsiales;Anaplasmataceae;Wolbachia;Dactylopius_coccus	Bacteria;Proteobacteria;Alphaproteobacteria;Rickettsiales;Anaplasmataceae;Wolbachia
Bacteria;Proteobacteria;Alphaproteobacteria;Rickettsiales;Anaplasmataceae;Wolbachia;Embioptera_sp._UVienna-2012	Bacteria;Proteobacteria;Alphaproteobacteria;Rickettsiales;Anaplasmataceae;Wolbachia
Bacteria;Proteobacteria;Alphaproteobacteria;Rickettsiales;Anaplasmataceae;Wolbachia;Formica_fusca	Bacteria;Proteobacteria;Alphaproteobacteria;Rickettsiales;Anaplasmataceae;Wolbachia
Bacteria;Proteobacteria;Alphaproteobacteria;Rickettsiales;Anaplasmataceae;Wolbachia;Gerris_buenoi	Bacteria;Proteobacteria;Alphaproteobacteria;Rickettsiales;Anaplasmataceae;Wolbachia
Bacteria;Proteobacteria;Alphaproteobacteria;Rickettsiales;Anaplasmataceae;Wolbachia;Homalodisca_vitripennis_(glassy-winged_sharpshooter)	Bacteria;Proteobacteria;Alphaproteobacteria;Rickettsiales;Anaplasmataceae;Wolbachia
Bacteria;Proteobacteria;Alphaproteobacteria;Rickettsiales;Anaplasmataceae;Wolbachia;Mengenilla_moldrzyki	Bacteria;Proteobacteria;Alphaproteobacteria;Rickettsiales;Anaplasmataceae;Wolbachia
Bacteria;Proteobacteria;Alphaproteobacteria;Rickettsiales;Anaplasmataceae;Wolbachia;Monomorium_pharaonis_(pharaoh_ant)	Bacteria;Proteobacteria;Alphaproteobacteria;Rickettsiales;Anaplasmataceae;Wolbachia
Bacteria;Proteobacteria;Alphaproteobacteria;Rickettsiales;Anaplasmataceae;Wolbachia;Proasellus_ibericus	Bacteria;Proteobacteria;Alphaproteobacteria;Rickettsiales;Anaplasmataceae;Wolbachia
Bacteria;Proteobacteria;Alphaproteobacteria;Rickettsiales;Anaplasmataceae;Wolbachia;Pseudomasaris_vespoides	Bacteria;Proteobacteria;Alphaproteobacteria;Rickettsiales;Anaplasmataceae;Wolbachia
Bacteria;Proteobacteria;Alphaproteobacteria;Rickettsiales;Anaplasmataceae;Wolbachia;Zorotypus_caudelli	Bacteria;Proteobacteria;Alphaproteobacteria;Rickettsiales;Anaplasmataceae;Wolbachia
Bacteria;Proteobacteria;Alphaproteobacteria;Rickettsiales;Midichloriaceae;Candidatus_Jidaibacter;Reticulomyxa_filosa	Bacteria;Proteobacteria;Alphaproteobacteria;Rickettsiales;Midichloriaceae;Candidatus_Jidaibacter
Bacteria;Proteobacteria;Alphaproteobacteria;Rickettsiales;Midichloriaceae;Candidatus_Lariskella;Ixodes_persulcatus_(taiga_tick)	Bacteria;Proteobacteria;Alphaproteobacteria;Rickettsiales;Midichloriaceae;Candidatus_Lariskella
Bacteria;Proteobacteria;Alphaproteobacteria;Rickettsiales;Rickettsiaceae;Rickettsia;Wolbachia_pipienti	Bacteria;Proteobacteria;Alphaproteobacteria;Rickettsiales;Rickettsiaceae;Rickettsia
Bacteria;Proteobacteria;Alphaproteobacteria;Sneathiellales;Sneathiellaceae;Taonella;Kaistia_sp._enrichment_culture_clone_35Fe70	Bacteria;Proteobacteria;Alphaproteobacteria;Sneathiellales;Sneathiellaceae;Taonella
Bacteria;Proteobacteria;Alphaproteobacteria;Sphingomonadales;Sphingomonadaceae;DSSF69;Punica_granatum_(pomegranate)	Bacteria;Proteobacteria;Alphaproteobacteria;Sphingomonadales;Sphingomonadaceae;DSSF69
Bacteria;Proteobacteria;Alphaproteobacteria;Sphingomonadales;Sphingomonadaceae;Novosphingobium;Corchorus_olitorius	Bacteria;Proteobacteria;Alphaproteobacteria;Sphingomonadales;Sphingomonadaceae;Novosphingobium
Bacteria;Proteobacteria;Alphaproteobacteria;Sphingomonadales;Sphingomonadaceae;Novosphingobium;Enterobacter_ludwigii	Bacteria;Proteobacteria;Alphaproteobacteria;Sphingomonadales;Sphingomonadaceae;Novosphingobium
Bacteria;Proteobacteria;Alphaproteobacteria;Sphingomonadales;Sphingomonadaceae;Sphingobium;Brassica_rapa_subsp._pekinensis_(Chinese_cabbage)	Bacteria;Proteobacteria;Alphaproteobacteria;Sphingomonadales;Sphingomonadaceae;Sphingobium
Bacteria;Proteobacteria;Alphaproteobacteria;Sphingomonadales;Sphingomonadaceae;Sphingomonas;Castanea_mollissima_(Chinese_chestnut)	Bacteria;Proteobacteria;Alphaproteobacteria;Sphingomonadales;Sphingomonadaceae;Sphingomonas
Bacteria;Proteobacteria;Alphaproteobacteria;Sphingomonadales;Sphingomonadaceae;Sphingomonas;Oryza_sativa_Indica_Group_(long-grained_rice)	Bacteria;Proteobacteria;Alphaproteobacteria;Sphingomonadales;Sphingomonadaceae;Sphingomonas
Bacteria;Proteobacteria;Alphaproteobacteria;Sphingomonadales;Sphingomonadaceae;Sphingomonas;Peromyscus_californicus_(California_mouse)	Bacteria;Proteobacteria;Alphaproteobacteria;Sphingomonadales;Sphingomonadaceae;Sphingomonas
Bacteria;Proteobacteria;Alphaproteobacteria;Sphingomonadales;Sphingomonadaceae;Sphingomonas;Solanum_lycopersicum_(tomato)	Bacteria;Proteobacteria;Alphaproteobacteria;Sphingomonadales;Sphingomonadaceae;Sphingomonas
Bacteria;Proteobacteria;Alphaproteobacteria;Sphingomonadales;Sphingomonadaceae;Sphingopyxis;Pseudomonas_sp._DMSP-1	Bacteria;Proteobacteria;Alphaproteobacteria;Sphingomonadales;Sphingomonadaceae;Sphingopyxis
Bacteria;Proteobacteria;Deltaproteobacteria;Desulfobacterales;Desulfobulbaceae;Desulfobulbus;Ephemera_danica	Bacteria;Proteobacteria;Deltaproteobacteria;Desulfobacterales;Desulfobulbaceae;Desulfobulbus
Bacteria;Proteobacteria;Deltaproteobacteria;Desulfovibrionales;Desulfovibrionaceae;Desulfovibrio;Blattella_germanica_(German_cockroach)	Bacteria;Proteobacteria;Deltaproteobacteria;Desulfovibrionales;Desulfovibrionaceae;Desulfovibrio
Bacteria;Proteobacteria;Deltaproteobacteria;Desulfovibrionales;Desulfovibrionaceae;Desulfovibrio;Ephemera_danica	Bacteria;Proteobacteria;Deltaproteobacteria;Desulfovibrionales;Desulfovibrionaceae;Desulfovibrio
Bacteria;Proteobacteria;Deltaproteobacteria;Oligoflexales;Oligoflexaceae;Oligoflexus;Thymallus_thymallus_(grayling)	Bacteria;Proteobacteria;Deltaproteobacteria;Oligoflexales;Oligoflexaceae;Oligoflexus
Bacteria;Proteobacteria;Gammaproteobacteria;Alteromonadales;Alteromonadaceae;Lytechinus_variegatus_(green_sea_urchin)	Bacteria;Proteobacteria;Gammaproteobacteria;Alteromonadales;Alteromonadaceae
Bacteria;Proteobacteria;Gammaproteobacteria;Alteromonadales;Alteromonadaceae;Rheinheimera;Cenchrus_americanus	Bacteria;Proteobacteria;Gammaproteobacteria;Alteromonadales;Alteromonadaceae;Rheinheimera
Bacteria;Proteobacteria;Gammaproteobacteria;Alteromonadales;Alteromonadaceae;Rheinheimera;Spumella_vulgaris	Bacteria;Proteobacteria;Gammaproteobacteria;Alteromonadales;Alteromonadaceae;Rheinheimera
Bacteria;Proteobacteria;Gammaproteobacteria;Alteromonadales;Alteromonadaceae;Salinimonas;Lytechinus_variegatus_(green_sea_urchin)	Bacteria;Proteobacteria;Gammaproteobacteria;Alteromonadales;Alteromonadaceae;Salinimonas
Bacteria;Proteobacteria;Gammaproteobacteria;Alteromonadales;Colwelliaceae;Colwellia;Gadus_morhua_(Atlantic_cod)	Bacteria;Proteobacteria;Gammaproteobacteria;Alteromonadales;Colwelliaceae;Colwellia
Bacteria;Proteobacteria;Gammaproteobacteria;Alteromonadales;Colwelliaceae;uncultured;Spumella-like_flagellate_JBM08	Bacteria;Proteobacteria;Gammaproteobacteria;Alteromonadales;Colwelliaceae;
Bacteria;Proteobacteria;Gammaproteobacteria;Alteromonadales;Marinobacteraceae;Marinobacter;Cladosiphon_okamuranus	Bacteria;Proteobacteria;Gammaproteobacteria;Alteromonadales;Marinobacteraceae;Marinobacter
Bacteria;Proteobacteria;Gammaproteobacteria;Alteromonadales;Marinobacteraceae;Marinobacter;Saccharina_japonica	Bacteria;Proteobacteria;Gammaproteobacteria;Alteromonadales;Marinobacteraceae;Marinobacter
Bacteria;Proteobacteria;Gammaproteobacteria;Alteromonadales;Moritellaceae;Moritella;Gadus_morhua_(Atlantic_cod)	Bacteria;Proteobacteria;Gammaproteobacteria;Alteromonadales;Moritellaceae;Moritella
Bacteria;Proteobacteria;Gammaproteobacteria;Arenicellales;Arenicellaceae;Candidatus_Thiosymbion;Robbea_sp._associated_bacterium_252_II_14	Bacteria;Proteobacteria;Gammaproteobacteria;Arenicellales;Arenicellaceae;Candidatus_Thiosymbion
Bacteria;Proteobacteria;Gammaproteobacteria;Arenicellales;Arenicellaceae;Candidatus_Thiosymbion;Robbea_sp._associated_bacterium_253_I_14	Bacteria;Proteobacteria;Gammaproteobacteria;Arenicellales;Arenicellaceae;Candidatus_Thiosymbion
Bacteria;Proteobacteria;Gammaproteobacteria;Arenicellales;Arenicellaceae;Thiolapillus;Alviniconcha_hessleri_gill_endosymbiont	Bacteria;Proteobacteria;Gammaproteobacteria;Arenicellales;Arenicellaceae;Thiolapillus
Bacteria;Proteobacteria;Gammaproteobacteria;Betaproteobacteriales;Burkholderiaceae;Achromobacter;Acropora_millepora	Bacteria;Proteobacteria;Gammaproteobacteria;Betaproteobacteriales;Burkholderiaceae;Achromobacter
Bacteria;Proteobacteria;Gammaproteobacteria;Betaproteobacteriales;Burkholderiaceae;Achromobacter;Streptomyces_psammoticus	Bacteria;Proteobacteria;Gammaproteobacteria;Betaproteobacteriales;Burkholderiaceae;Achromobacter
Bacteria;Proteobacteria;Gammaproteobacteria;Betaproteobacteriales;Burkholderiaceae;Achromobacter;Streptomyces_sp._AQB.SKKU_20	Bacteria;Proteobacteria;Gammaproteobacteria;Betaproteobacteriales;Burkholderiaceae;Achromobacter
Bacteria;Proteobacteria;Gammaproteobacteria;Betaproteobacteriales;Burkholderiaceae;Achromobacter;Trachelomonas_armata	Bacteria;Proteobacteria;Gammaproteobacteria;Betaproteobacteriales;Burkholderiaceae;Achromobacter
Bacteria;Proteobacteria;Gammaproteobacteria;Betaproteobacteriales;Burkholderiaceae;Acidovorax;Cenchrus_americanus	Bacteria;Proteobacteria;Gammaproteobacteria;Betaproteobacteriales;Burkholderiaceae;Acidovorax
Bacteria;Proteobacteria;Gammaproteobacteria;Betaproteobacteriales;Burkholderiaceae;Advenella;Ochrobactrum_pseudogrignonense	Bacteria;Proteobacteria;Gammaproteobacteria;Betaproteobacteriales;Burkholderiaceae;Advenella
Bacteria;Proteobacteria;Gammaproteobacteria;Betaproteobacteriales;Burkholderiaceae;Aquabacterium;Cenchrus_americanus	Bacteria;Proteobacteria;Gammaproteobacteria;Betaproteobacteriales;Burkholderiaceae;Aquabacterium
Bacteria;Proteobacteria;Gammaproteobacteria;Betaproteobacteriales;Burkholderiaceae;Aquabacterium;Drosophila_biarmipe	Bacteria;Proteobacteria;Gammaproteobacteria;Betaproteobacteriales;Burkholderiaceae;Aquabacterium
Bacteria;Proteobacteria;Gammaproteobacteria;Betaproteobacteriales;Burkholderiaceae;Burkholderia-Caballeronia-Paraburkholderia;Anoplocnemis_curvipes	Bacteria;Proteobacteria;Gammaproteobacteria;Betaproteobacteriales;Burkholderiaceae;Burkholderia-Caballeronia-Paraburkholderia
Bacteria;Proteobacteria;Gammaproteobacteria;Betaproteobacteriales;Burkholderiaceae;Burkholderia-Caballeronia-Paraburkholderia;Antheraea_pernyi_(Chinese_oak_silkmoth)	Bacteria;Proteobacteria;Gammaproteobacteria;Betaproteobacteriales;Burkholderiaceae;Burkholderia-Caballeronia-Paraburkholderia
Bacteria;Proteobacteria;Gammaproteobacteria;Betaproteobacteriales;Burkholderiaceae;Burkholderia-Caballeronia-Paraburkholderia;Aquamicrobium_sp._SK-2	Bacteria;Proteobacteria;Gammaproteobacteria;Betaproteobacteriales;Burkholderiaceae;Burkholderia-Caballeronia-Paraburkholderia
Bacteria;Proteobacteria;Gammaproteobacteria;Betaproteobacteriales;Burkholderiaceae;Burkholderia-Caballeronia-Paraburkholderia;Caenorhabditis_elegans	Bacteria;Proteobacteria;Gammaproteobacteria;Betaproteobacteriales;Burkholderiaceae;Burkholderia-Caballeronia-Paraburkholderia
Bacteria;Proteobacteria;Gammaproteobacteria;Betaproteobacteriales;Burkholderiaceae;Burkholderia-Caballeronia-Paraburkholderia;Micrococcus_luteus	Bacteria;Proteobacteria;Gammaproteobacteria;Betaproteobacteriales;Burkholderiaceae;Burkholderia-Caballeronia-Paraburkholderia
Bacteria;Proteobacteria;Gammaproteobacteria;Betaproteobacteriales;Burkholderiaceae;Comamonas;Polyangium_sp._CC-YHH645	Bacteria;Proteobacteria;Gammaproteobacteria;Betaproteobacteriales;Burkholderiaceae;Comamonas
Bacteria;Proteobacteria;Gammaproteobacteria;Betaproteobacteriales;Burkholderiaceae;Curvibacter;Spumella_sp._AR4D6	Bacteria;Proteobacteria;Gammaproteobacteria;Betaproteobacteriales;Burkholderiaceae;Curvibacter
Bacteria;Proteobacteria;Gammaproteobacteria;Betaproteobacteriales;Burkholderiaceae;Curvibacter;Streptococcus_sanguinis	Bacteria;Proteobacteria;Gammaproteobacteria;Betaproteobacteriales;Burkholderiaceae;Curvibacter
Bacteria;Proteobacteria;Gammaproteobacteria;Betaproteobacteriales;Burkholderiaceae;Duganella;Triticum_aestivum_(bread_wheat)	Bacteria;Proteobacteria;Gammaproteobacteria;Betaproteobacteriales;Burkholderiaceae;Duganella
Bacteria;Proteobacteria;Gammaproteobacteria;Betaproteobacteriales;Burkholderiaceae;Duganella;Triticum_aestivum_(bread_wheat)	Bacteria;Proteobacteria;Gammaproteobacteria;Betaproteobacteriales;Burkholderiaceae;Duganella
Bacteria;Proteobacteria;Gammaproteobacteria;Betaproteobacteriales;Burkholderiaceae;Herminiimonas;ultramicrobacterium_str._ISSDS-831	Bacteria;Proteobacteria;Gammaproteobacteria;Betaproteobacteriales;Burkholderiaceae;Herminiimonas
Bacteria;Proteobacteria;Gammaproteobacteria;Betaproteobacteriales;Burkholderiaceae;Herminiimonas;ultramicrobacterium_str._Um1	Bacteria;Proteobacteria;Gammaproteobacteria;Betaproteobacteriales;Burkholderiaceae;Herminiimonas
Bacteria;Proteobacteria;Gammaproteobacteria;Betaproteobacteriales;Burkholderiaceae;Hydrogenophaga;Chaetosphaeridium_globosum	Bacteria;Proteobacteria;Gammaproteobacteria;Betaproteobacteriales;Burkholderiaceae;Hydrogenophaga
Bacteria;Proteobacteria;Gammaproteobacteria;Betaproteobacteriales;Burkholderiaceae;Hydrogenophaga;Proasellus_meridianus	Bacteria;Proteobacteria;Gammaproteobacteria;Betaproteobacteriales;Burkholderiaceae;Hydrogenophaga
Bacteria;Proteobacteria;Gammaproteobacteria;Betaproteobacteriales;Burkholderiaceae;Ideonella;Argulus_siamensis	Bacteria;Proteobacteria;Gammaproteobacteria;Betaproteobacteriales;Burkholderiaceae;Ideonella
Bacteria;Proteobacteria;Gammaproteobacteria;Betaproteobacteriales;Burkholderiaceae;Ideonella;Cenchrus_americanus	Bacteria;Proteobacteria;Gammaproteobacteria;Betaproteobacteriales;Burkholderiaceae;Ideonella
Bacteria;Proteobacteria;Gammaproteobacteria;Betaproteobacteriales;Burkholderiaceae;Ideonella;Hyalella_azteca	Bacteria;Proteobacteria;Gammaproteobacteria;Betaproteobacteriales;Burkholderiaceae;Ideonella
Bacteria;Proteobacteria;Gammaproteobacteria;Betaproteobacteriales;Burkholderiaceae;Janthinobacterium;Acipenser_sinensis_(Chinese_sturgeon)	Bacteria;Proteobacteria;Gammaproteobacteria;Betaproteobacteriales;Burkholderiaceae;Janthinobacterium
Bacteria;Proteobacteria;Gammaproteobacteria;Betaproteobacteriales;Burkholderiaceae;Janthinobacterium;Dictyostelium_polycarpum	Bacteria;Proteobacteria;Gammaproteobacteria;Betaproteobacteriales;Burkholderiaceae;Janthinobacterium
Bacteria;Proteobacteria;Gammaproteobacteria;Betaproteobacteriales;Burkholderiaceae;Janthinobacterium;Dictyostelium_polycarpum	Bacteria;Proteobacteria;Gammaproteobacteria;Betaproteobacteriales;Burkholderiaceae;Janthinobacterium
Bacteria;Proteobacteria;Gammaproteobacteria;Betaproteobacteriales;Burkholderiaceae;Janthinobacterium;Farfantepenaeus_aztecus_(brown_shrimp)	Bacteria;Proteobacteria;Gammaproteobacteria;Betaproteobacteriales;Burkholderiaceae;Janthinobacterium
Bacteria;Proteobacteria;Gammaproteobacteria;Betaproteobacteriales;Burkholderiaceae;Janthinobacterium;Litopenaeus_vannamei_(Pacific_white_shrimp)	Bacteria;Proteobacteria;Gammaproteobacteria;Betaproteobacteriales;Burkholderiaceae;Janthinobacterium
Bacteria;Proteobacteria;Gammaproteobacteria;Betaproteobacteriales;Burkholderiaceae;Kinneretia;Reticulomyxa_filosa	Bacteria;Proteobacteria;Gammaproteobacteria;Betaproteobacteriales;Burkholderiaceae;Kinneretia
Bacteria;Proteobacteria;Gammaproteobacteria;Betaproteobacteriales;Burkholderiaceae;Leptothrix;Bragasellus_peltatus	Bacteria;Proteobacteria;Gammaproteobacteria;Betaproteobacteriales;Burkholderiaceae;Leptothrix
Bacteria;Proteobacteria;Gammaproteobacteria;Betaproteobacteriales;Burkholderiaceae;Massilia;Triticum_aestivum_(bread_wheat)	Bacteria;Proteobacteria;Gammaproteobacteria;Betaproteobacteriales;Burkholderiaceae;Massilia
Bacteria;Proteobacteria;Gammaproteobacteria;Betaproteobacteriales;Burkholderiaceae;Noviherbaspirillum;Alligator_sinensis_(Chinese_alligator)	Bacteria;Proteobacteria;Gammaproteobacteria;Betaproteobacteriales;Burkholderiaceae;Noviherbaspirillum
Bacteria;Proteobacteria;Gammaproteobacteria;Betaproteobacteriales;Burkholderiaceae;Paucibacter;Cenchrus_americanus	Bacteria;Proteobacteria;Gammaproteobacteria;Betaproteobacteriales;Burkholderiaceae;Paucibacter
Bacteria;Proteobacteria;Gammaproteobacteria;Betaproteobacteriales;Burkholderiaceae;Pelomonas;Chaetosphaeridium_globosum	Bacteria;Proteobacteria;Gammaproteobacteria;Betaproteobacteriales;Burkholderiaceae;Pelomonas
Bacteria;Proteobacteria;Gammaproteobacteria;Betaproteobacteriales;Burkholderiaceae;Pigmentiphaga;Mycobacterium_abscessus_subsp._abscessus	Bacteria;Proteobacteria;Gammaproteobacteria;Betaproteobacteriales;Burkholderiaceae;Pigmentiphaga
Bacteria;Proteobacteria;Gammaproteobacteria;Betaproteobacteriales;Burkholderiaceae;Rhizobacter;Bragasellus_peltatus	Bacteria;Proteobacteria;Gammaproteobacteria;Betaproteobacteriales;Burkholderiaceae;Rhizobacter
Bacteria;Proteobacteria;Gammaproteobacteria;Betaproteobacteriales;Burkholderiaceae;Rhizobacter;Chaetosphaeridium_globosum	Bacteria;Proteobacteria;Gammaproteobacteria;Betaproteobacteriales;Burkholderiaceae;Rhizobacter
Bacteria;Proteobacteria;Gammaproteobacteria;Betaproteobacteriales;Burkholderiaceae;Sphaerotilus;Gleditsia_sinensis	Bacteria;Proteobacteria;Gammaproteobacteria;Betaproteobacteriales;Burkholderiaceae;Sphaerotilus
Bacteria;Proteobacteria;Gammaproteobacteria;Betaproteobacteriales;Burkholderiaceae;uncultured;Bragasellus_peltatus	Bacteria;Proteobacteria;Gammaproteobacteria;Betaproteobacteriales;Burkholderiaceae;
Bacteria;Proteobacteria;Gammaproteobacteria;Betaproteobacteriales;Burkholderiaceae;uncultured;Hydra_vulgaris	Bacteria;Proteobacteria;Gammaproteobacteria;Betaproteobacteriales;Burkholderiaceae;
Bacteria;Proteobacteria;Gammaproteobacteria;Betaproteobacteriales;Methylophilaceae;Methylobacillus;Aminomonas_aminovorus	Bacteria;Proteobacteria;Gammaproteobacteria;Betaproteobacteriales;Methylophilaceae;Methylobacillus
Bacteria;Proteobacteria;Gammaproteobacteria;Betaproteobacteriales;Rhodocyclaceae;Propionivibrio;Coptotermes_gestroi	Bacteria;Proteobacteria;Gammaproteobacteria;Betaproteobacteriales;Rhodocyclaceae;Propionivibrio
Bacteria;Proteobacteria;Gammaproteobacteria;Betaproteobacteriales;Rhodocyclaceae;Sulfuritalea;Ephemera_danica	Bacteria;Proteobacteria;Gammaproteobacteria;Betaproteobacteriales;Rhodocyclaceae;Sulfuritalea
Bacteria;Proteobacteria;Gammaproteobacteria;Betaproteobacteriales;Rhodocyclaceae;uncultured;Ephemera_danica	Bacteria;Proteobacteria;Gammaproteobacteria;Betaproteobacteriales;Rhodocyclaceae;uncultured
Bacteria;Proteobacteria;Gammaproteobacteria;Cellvibrionales;Cellvibrionaceae;Aestuariicella;Gammaproteobacteria_sp._BM08	Bacteria;Proteobacteria;Gammaproteobacteria;Cellvibrionales;Cellvibrionaceae;Aestuariicella
Bacteria;Proteobacteria;Gammaproteobacteria;Cellvibrionales;Halieaceae;Halioglobus;Saccharina_japonica	Bacteria;Proteobacteria;Gammaproteobacteria;Cellvibrionales;Halieaceae;Halioglobus
Bacteria;Proteobacteria;Gammaproteobacteria;Cellvibrionales;Porticoccaceae;C1-B045;Cladosiphon_okamuranus	Bacteria;Proteobacteria;Gammaproteobacteria;Cellvibrionales;Porticoccaceae;C1-B045
Bacteria;Proteobacteria;Gammaproteobacteria;Cellvibrionales;Spongiibacteraceae;Sinobacterium;Gammaproteobacteria_sp._Y81	Bacteria;Proteobacteria;Gammaproteobacteria;Cellvibrionales;Spongiibacteraceae;Sinobacterium
Bacteria;Proteobacteria;Gammaproteobacteria;Diplorickettsiales;Diplorickettsiaceae;Rickettsiella;Proasellus_assaforensis	Bacteria;Proteobacteria;Gammaproteobacteria;Diplorickettsiales;Diplorickettsiaceae;Rickettsiella
Bacteria;Proteobacteria;Gammaproteobacteria;Enterobacteriales;Enterobacteriaceae;Budvicia;enterobacterium_dtb112	Bacteria;Proteobacteria;Gammaproteobacteria;Enterobacteriales;Enterobacteriaceae;Budvicia
Bacteria;Proteobacteria;Gammaproteobacteria;Enterobacteriales;Enterobacteriaceae;Candidatus_Hamiltonella;male-killer_in_Chilomenes_sexmaculatus	Bacteria;Proteobacteria;Gammaproteobacteria;Enterobacteriales;Enterobacteriaceae;Candidatus_Hamiltonella
Bacteria;Proteobacteria;Gammaproteobacteria;Enterobacteriales;Enterobacteriaceae;Candidatus_Rosenkranzia;Acanthosoma_haemorrhoidale	Bacteria;Proteobacteria;Gammaproteobacteria;Enterobacteriales;Enterobacteriaceae;Candidatus_Rosenkranzia
Bacteria;Proteobacteria;Gammaproteobacteria;Enterobacteriales;Enterobacteriaceae;Cronobacter;Lysinibacillus_fusiformis	Bacteria;Proteobacteria;Gammaproteobacteria;Enterobacteriales;Enterobacteriaceae;Cronobacter
Bacteria;Proteobacteria;Gammaproteobacteria;Enterobacteriales;Enterobacteriaceae;Enterobacter;Bacteroides_fragilis	Bacteria;Proteobacteria;Gammaproteobacteria;Enterobacteriales;Enterobacteriaceae;Enterobacter
Bacteria;Proteobacteria;Gammaproteobacteria;Enterobacteriales;Enterobacteriaceae;Enterobacter;enterobacterium_EA61	Bacteria;Proteobacteria;Gammaproteobacteria;Enterobacteriales;Enterobacteriaceae;Enterobacter
Bacteria;Proteobacteria;Gammaproteobacteria;Enterobacteriales;Enterobacteriaceae;Enterobacter;Microbacterium_sp._SUBG005	Bacteria;Proteobacteria;Gammaproteobacteria;Enterobacteriales;Enterobacteriaceae;Enterobacter
Bacteria;Proteobacteria;Gammaproteobacteria;Enterobacteriales;Enterobacteriaceae;Enterobacter;Micrococcus_luteus	Bacteria;Proteobacteria;Gammaproteobacteria;Enterobacteriales;Enterobacteriaceae;Enterobacter
Bacteria;Proteobacteria;Gammaproteobacteria;Enterobacteriales;Enterobacteriaceae;Enterobacter;Oryza_sativa_Indica_Group_(long-grained_rice)	Bacteria;Proteobacteria;Gammaproteobacteria;Enterobacteriales;Enterobacteriaceae;Enterobacter
Bacteria;Proteobacteria;Gammaproteobacteria;Enterobacteriales;Enterobacteriaceae;Erwinia;Frankliniella_occidentalis_(western_flower_thrips)	Bacteria;Proteobacteria;Gammaproteobacteria;Enterobacteriales;Enterobacteriaceae;Erwinia
Bacteria;Proteobacteria;Gammaproteobacteria;Enterobacteriales;Enterobacteriaceae;Erwinia;Hordeum_vulgare_subsp._vulgare_(domesticated_barley)	Bacteria;Proteobacteria;Gammaproteobacteria;Enterobacteriales;Enterobacteriaceae;Erwinia
Bacteria;Proteobacteria;Gammaproteobacteria;Enterobacteriales;Enterobacteriaceae;Escherichia-Shigella;Burkholderia_pseudomallei	Bacteria;Proteobacteria;Gammaproteobacteria;Enterobacteriales;Enterobacteriaceae;Escherichia-Shigella
Bacteria;Proteobacteria;Gammaproteobacteria;Enterobacteriales;Enterobacteriaceae;Escherichia-Shigella;Capra_hircus_(goat)	Bacteria;Proteobacteria;Gammaproteobacteria;Enterobacteriales;Enterobacteriaceae;Escherichia-Shigella
Bacteria;Proteobacteria;Gammaproteobacteria;Enterobacteriales;Enterobacteriaceae;Escherichia-Shigella;Coregonus_lavaretus_(common_whitefish)	Bacteria;Proteobacteria;Gammaproteobacteria;Enterobacteriales;Enterobacteriaceae;Escherichia-Shigella
Bacteria;Proteobacteria;Gammaproteobacteria;Enterobacteriales;Enterobacteriaceae;Escherichia-Shigella;Oryza_sativa_Indica_Group_(long-grained_rice)	Bacteria;Proteobacteria;Gammaproteobacteria;Enterobacteriales;Enterobacteriaceae;Escherichia-Shigella
Bacteria;Proteobacteria;Gammaproteobacteria;Enterobacteriales;Enterobacteriaceae;Escherichia-Shigella;Streptomyces_sp._Q1	Bacteria;Proteobacteria;Gammaproteobacteria;Enterobacteriales;Enterobacteriaceae;Escherichia-Shigella
Bacteria;Proteobacteria;Gammaproteobacteria;Enterobacteriales;Enterobacteriaceae;Klebsiella;Cenchrus_americanus	Bacteria;Proteobacteria;Gammaproteobacteria;Enterobacteriales;Enterobacteriaceae;Klebsiella
Bacteria;Proteobacteria;Gammaproteobacteria;Enterobacteriales;Enterobacteriaceae;Kluyvera;Diabrotica_virgifera_virgifera_(western_corn_rootworm)	Bacteria;Proteobacteria;Gammaproteobacteria;Enterobacteriales;Enterobacteriaceae;Kluyvera
Bacteria;Proteobacteria;Gammaproteobacteria;Enterobacteriales;Enterobacteriaceae;Pantoea;Cenchrus_americanus	Bacteria;Proteobacteria;Gammaproteobacteria;Enterobacteriales;Enterobacteriaceae;Pantoea
Bacteria;Proteobacteria;Gammaproteobacteria;Enterobacteriales;Enterobacteriaceae;Pantoea;Oryza_sativa_Indica_Group_(long-grained_rice)	Bacteria;Proteobacteria;Gammaproteobacteria;Enterobacteriales;Enterobacteriaceae;Pantoea
Bacteria;Proteobacteria;Gammaproteobacteria;Enterobacteriales;Enterobacteriaceae;Pantoea;Staphylococcus_epidermidis	Bacteria;Proteobacteria;Gammaproteobacteria;Enterobacteriales;Enterobacteriaceae;Pantoea
Bacteria;Proteobacteria;Gammaproteobacteria;Enterobacteriales;Enterobacteriaceae;Pantoea;Triticum_aestivum_(bread_wheat)	Bacteria;Proteobacteria;Gammaproteobacteria;Enterobacteriales;Enterobacteriaceae;Pantoea
Bacteria;Proteobacteria;Gammaproteobacteria;Enterobacteriales;Enterobacteriaceae;Pantoea;uncultured_Burkholderia_sp.	Bacteria;Proteobacteria;Gammaproteobacteria;Enterobacteriales;Enterobacteriaceae;Pantoea
Bacteria;Proteobacteria;Gammaproteobacteria;Enterobacteriales;Enterobacteriaceae;Pectobacterium;Arcobacter_lanthieri	Bacteria;Proteobacteria;Gammaproteobacteria;Enterobacteriales;Enterobacteriaceae;Pectobacterium
Bacteria;Proteobacteria;Gammaproteobacteria;Enterobacteriales;Enterobacteriaceae;Rosenbergiella;Actinidia_chinensis	Bacteria;Proteobacteria;Gammaproteobacteria;Enterobacteriales;Enterobacteriaceae;Rosenbergiella
Bacteria;Proteobacteria;Gammaproteobacteria;Enterobacteriales;Enterobacteriaceae;Serratia;Oryza_sativa_Indica_Group_(long-grained_rice)	Bacteria;Proteobacteria;Gammaproteobacteria;Enterobacteriales;Enterobacteriaceae;Serratia
Bacteria;Proteobacteria;Gammaproteobacteria;Enterobacteriales;Enterobacteriaceae;Serratia;Rhodotorula_mucilaginosa/Serratia_marcescens_fusant	Bacteria;Proteobacteria;Gammaproteobacteria;Enterobacteriales;Enterobacteriaceae;Serratia_marcescens_fusant
Bacteria;Proteobacteria;Gammaproteobacteria;Enterobacteriales;Enterobacteriaceae;Sodalis;Sitophilus_zeamais_(maize_weevil)	Bacteria;Proteobacteria;Gammaproteobacteria;Enterobacteriales;Enterobacteriaceae;Sodalis
Bacteria;Proteobacteria;Gammaproteobacteria;Gammaproteobacteria_Incertae_Sedis;Unknown_Family;Acidibacter;Punica_granatum_(pomegranate)	Bacteria;Proteobacteria;Gammaproteobacteria;Gammaproteobacteria_Incertae_Sedis;Unknown_Family;Acidibacter
Bacteria;Proteobacteria;Gammaproteobacteria;Nitrosococcales;Methylophagaceae;Methylophaga;Saccharina_japonica	Bacteria;Proteobacteria;Gammaproteobacteria;Nitrosococcales;Methylophagaceae;Methylophaga
Bacteria;Proteobacteria;Gammaproteobacteria;Oceanospirillales;Endozoicomonadaceae;Endozoicomonas;Acropora_cervicornis	Bacteria;Proteobacteria;Gammaproteobacteria;Oceanospirillales;Endozoicomonadaceae;Endozoicomonas
Bacteria;Proteobacteria;Gammaproteobacteria;Oceanospirillales;Endozoicomonadaceae;Endozoicomonas;Acropora_millepora	Bacteria;Proteobacteria;Gammaproteobacteria;Oceanospirillales;Endozoicomonadaceae;Endozoicomonas
Bacteria;Proteobacteria;Gammaproteobacteria;Oceanospirillales;Endozoicomonadaceae;Endozoicomonas;Palythoa_caribaeorum	Bacteria;Proteobacteria;Gammaproteobacteria;Oceanospirillales;Endozoicomonadaceae;Endozoicomonas
Bacteria;Proteobacteria;Gammaproteobacteria;Oceanospirillales;Halomonadaceae;Candidatus_Portiera;Bemisia_tabaci	Bacteria;Proteobacteria;Gammaproteobacteria;Oceanospirillales;Halomonadaceae;Candidatus_Portiera
Bacteria;Proteobacteria;Gammaproteobacteria;Oceanospirillales;Halomonadaceae;Candidatus_Portiera;Gossypium_arboreum	Bacteria;Proteobacteria;Gammaproteobacteria;Oceanospirillales;Halomonadaceae;Candidatus_Portiera
Bacteria;Proteobacteria;Gammaproteobacteria;Oceanospirillales;Marinomonadaceae;Marinomonas;Achromobacter_cholinophagum	Bacteria;Proteobacteria;Gammaproteobacteria;Oceanospirillales;Marinomonadaceae;Marinomonas
Bacteria;Proteobacteria;Gammaproteobacteria;Oceanospirillales;Saccharospirillaceae;Thalassolituus;Robbea_sp._associated_bacterium_2	Bacteria;Proteobacteria;Gammaproteobacteria;Oceanospirillales;Saccharospirillaceae;Thalassolituus
Bacteria;Proteobacteria;Gammaproteobacteria;Piscirickettsiales;Piscirickettsiaceae;Piscirickettsia;Tasmanian_Rickettsia-like_organism	Bacteria;Proteobacteria;Gammaproteobacteria;Piscirickettsiales;Piscirickettsiaceae;Piscirickettsia
Bacteria;Proteobacteria;Gammaproteobacteria;Pseudomonadales;Moraxellaceae;Acinetobacter;Ambystoma_mexicanum_(axolotl)	Bacteria;Proteobacteria;Gammaproteobacteria;Pseudomonadales;Moraxellaceae;Acinetobacter
Bacteria;Proteobacteria;Gammaproteobacteria;Pseudomonadales;Moraxellaceae;Acinetobacter;Cenchrus_americanus	Bacteria;Proteobacteria;Gammaproteobacteria;Pseudomonadales;Moraxellaceae;Acinetobacter
Bacteria;Proteobacteria;Gammaproteobacteria;Pseudomonadales;Moraxellaceae;Acinetobacter;Citrus_maxima	Bacteria;Proteobacteria;Gammaproteobacteria;Pseudomonadales;Moraxellaceae;Acinetobacter
Bacteria;Proteobacteria;Gammaproteobacteria;Pseudomonadales;Moraxellaceae;Acinetobacter;Eogystia_hippophaecolus	Bacteria;Proteobacteria;Gammaproteobacteria;Pseudomonadales;Moraxellaceae;Acinetobacter
Bacteria;Proteobacteria;Gammaproteobacteria;Pseudomonadales;Moraxellaceae;Acinetobacter;Rhynchophorus_ferrugineus_(red_palm_weevil)	Bacteria;Proteobacteria;Gammaproteobacteria;Pseudomonadales;Moraxellaceae;Acinetobacter
Bacteria;Proteobacteria;Gammaproteobacteria;Pseudomonadales;Moraxellaceae;Acinetobacter;Sargassum_muticum	Bacteria;Proteobacteria;Gammaproteobacteria;Pseudomonadales;Moraxellaceae;Acinetobacter
Bacteria;Proteobacteria;Gammaproteobacteria;Pseudomonadales;Moraxellaceae;Enhydrobacter;Aptenodytes_forsteri_(emperor_penguin)	Bacteria;Proteobacteria;Gammaproteobacteria;Pseudomonadales;Moraxellaceae;Enhydrobacter
Bacteria;Proteobacteria;Gammaproteobacteria;Pseudomonadales;Moraxellaceae;Enhydrobacter;Hydra_vulgaris	Bacteria;Proteobacteria;Gammaproteobacteria;Pseudomonadales;Moraxellaceae;Enhydrobacter
Bacteria;Proteobacteria;Gammaproteobacteria;Pseudomonadales;Moraxellaceae;Enhydrobacter;Lepisosteus_oculatus_(spotted_gar)	Bacteria;Proteobacteria;Gammaproteobacteria;Pseudomonadales;Moraxellaceae;Enhydrobacter
Bacteria;Proteobacteria;Gammaproteobacteria;Pseudomonadales;Moraxellaceae;Enhydrobacter;Petunia_integrifolia	Bacteria;Proteobacteria;Gammaproteobacteria;Pseudomonadales;Moraxellaceae;Enhydrobacter
Bacteria;Proteobacteria;Gammaproteobacteria;Pseudomonadales;Moraxellaceae;Enhydrobacter;Solanum_melongena_(eggplant)	Bacteria;Proteobacteria;Gammaproteobacteria;Pseudomonadales;Moraxellaceae;Enhydrobacter
Bacteria;Proteobacteria;Gammaproteobacteria;Pseudomonadales;Moraxellaceae;Psychrobacter;Pseudopleuronectes_yokohamae_(marbled_flounder)	Bacteria;Proteobacteria;Gammaproteobacteria;Pseudomonadales;Moraxellaceae;Psychrobacter
Bacteria;Proteobacteria;Gammaproteobacteria;Pseudomonadales;Pseudomonadaceae;Pseudomonas;Acytostelium_ellipticum	Bacteria;Proteobacteria;Gammaproteobacteria;Pseudomonadales;Pseudomonadaceae;Pseudomonas
Bacteria;Proteobacteria;Gammaproteobacteria;Pseudomonadales;Pseudomonadaceae;Pseudomonas;Amia_calva_(bowfin)	Bacteria;Proteobacteria;Gammaproteobacteria;Pseudomonadales;Pseudomonadaceae;Pseudomonas
Bacteria;Proteobacteria;Gammaproteobacteria;Pseudomonadales;Pseudomonadaceae;Pseudomonas;Amphilophus_citrinellus_(Midas_cichlid)	Bacteria;Proteobacteria;Gammaproteobacteria;Pseudomonadales;Pseudomonadaceae;Pseudomonas
Bacteria;Proteobacteria;Gammaproteobacteria;Pseudomonadales;Pseudomonadaceae;Pseudomonas;Anisakis_simplex_(herring_worm)	Bacteria;Proteobacteria;Gammaproteobacteria;Pseudomonadales;Pseudomonadaceae;Pseudomonas
Bacteria;Proteobacteria;Gammaproteobacteria;Pseudomonadales;Pseudomonadaceae;Pseudomonas;Apis_mellifera_(honey_bee)	Bacteria;Proteobacteria;Gammaproteobacteria;Pseudomonadales;Pseudomonadaceae;Pseudomonas
Bacteria;Proteobacteria;Gammaproteobacteria;Pseudomonadales;Pseudomonadaceae;Pseudomonas;Blattella_germanica_(German_cockroach)	Bacteria;Proteobacteria;Gammaproteobacteria;Pseudomonadales;Pseudomonadaceae;Pseudomonas
Bacteria;Proteobacteria;Gammaproteobacteria;Pseudomonadales;Pseudomonadaceae;Pseudomonas;Burkholderia_cepacia	Bacteria;Proteobacteria;Gammaproteobacteria;Pseudomonadales;Pseudomonadaceae;Pseudomonas
Bacteria;Proteobacteria;Gammaproteobacteria;Pseudomonadales;Pseudomonadaceae;Pseudomonas;Burkholderia_sp._AB2	Bacteria;Proteobacteria;Gammaproteobacteria;Pseudomonadales;Pseudomonadaceae;Pseudomonas
Bacteria;Proteobacteria;Gammaproteobacteria;Pseudomonadales;Pseudomonadaceae;Pseudomonas;Burkholderia_sp._CCBAU_23014	Bacteria;Proteobacteria;Gammaproteobacteria;Pseudomonadales;Pseudomonadaceae;Pseudomonas
Bacteria;Proteobacteria;Gammaproteobacteria;Pseudomonadales;Pseudomonadaceae;Pseudomonas;Burkholderia_sp._IBUN_S1602	Bacteria;Proteobacteria;Gammaproteobacteria;Pseudomonadales;Pseudomonadaceae;Pseudomonas
Bacteria;Proteobacteria;Gammaproteobacteria;Pseudomonadales;Pseudomonadaceae;Pseudomonas;Burkholderia_sp._NFACC33-1	Bacteria;Proteobacteria;Gammaproteobacteria;Pseudomonadales;Pseudomonadaceae;Pseudomonas
Bacteria;Proteobacteria;Gammaproteobacteria;Pseudomonadales;Pseudomonadaceae;Pseudomonas;Ceuthophilus_sp._AD-2013	Bacteria;Proteobacteria;Gammaproteobacteria;Pseudomonadales;Pseudomonadaceae;Pseudomonas
Bacteria;Proteobacteria;Gammaproteobacteria;Pseudomonadales;Pseudomonadaceae;Pseudomonas;Chryseobacterium_lactis	Bacteria;Proteobacteria;Gammaproteobacteria;Pseudomonadales;Pseudomonadaceae;Pseudomonas
Bacteria;Proteobacteria;Gammaproteobacteria;Pseudomonadales;Pseudomonadaceae;Pseudomonas;Curtobacterium_flaccumfaciens	Bacteria;Proteobacteria;Gammaproteobacteria;Pseudomonadales;Pseudomonadaceae;Pseudomonas
Bacteria;Proteobacteria;Gammaproteobacteria;Pseudomonadales;Pseudomonadaceae;Pseudomonas;Gossypium_hirsutum_(cotton)	Bacteria;Proteobacteria;Gammaproteobacteria;Pseudomonadales;Pseudomonadaceae;Pseudomonas
Bacteria;Proteobacteria;Gammaproteobacteria;Pseudomonadales;Pseudomonadaceae;Pseudomonas;Hevea_brasiliensis	Bacteria;Proteobacteria;Gammaproteobacteria;Pseudomonadales;Pseudomonadaceae;Pseudomonas
Bacteria;Proteobacteria;Gammaproteobacteria;Pseudomonadales;Pseudomonadaceae;Pseudomonas;Hyphomicrobium_vulgare	Bacteria;Proteobacteria;Gammaproteobacteria;Pseudomonadales;Pseudomonadaceae;Pseudomonas
Bacteria;Proteobacteria;Gammaproteobacteria;Pseudomonadales;Pseudomonadaceae;Pseudomonas;Hypsibius_dujardini	Bacteria;Proteobacteria;Gammaproteobacteria;Pseudomonadales;Pseudomonadaceae;Pseudomonas
Bacteria;Proteobacteria;Gammaproteobacteria;Pseudomonadales;Pseudomonadaceae;Pseudomonas;Locusta_migratoria_(migratory_locust)	Bacteria;Proteobacteria;Gammaproteobacteria;Pseudomonadales;Pseudomonadaceae;Pseudomonas
Bacteria;Proteobacteria;Gammaproteobacteria;Pseudomonadales;Pseudomonadaceae;Pseudomonas;Lytechinus_variegatus_(green_sea_urchin)	Bacteria;Proteobacteria;Gammaproteobacteria;Pseudomonadales;Pseudomonadaceae;Pseudomonas
Bacteria;Proteobacteria;Gammaproteobacteria;Pseudomonadales;Pseudomonadaceae;Pseudomonas;Mischocyttarus_flavitarsis	Bacteria;Proteobacteria;Gammaproteobacteria;Pseudomonadales;Pseudomonadaceae;Pseudomonas
Bacteria;Proteobacteria;Gammaproteobacteria;Pseudomonadales;Pseudomonadaceae;Pseudomonas;Ostrinia_furnacalis_(Asian_corn_borer)	Bacteria;Proteobacteria;Gammaproteobacteria;Pseudomonadales;Pseudomonadaceae;Pseudomonas
Bacteria;Proteobacteria;Gammaproteobacteria;Pseudomonadales;Pseudomonadaceae;Pseudomonas;Sargassum_henslowianum	Bacteria;Proteobacteria;Gammaproteobacteria;Pseudomonadales;Pseudomonadaceae;Pseudomonas
Bacteria;Proteobacteria;Gammaproteobacteria;Pseudomonadales;Pseudomonadaceae;Pseudomonas;Spumella_sp._AR4D6	Bacteria;Proteobacteria;Gammaproteobacteria;Pseudomonadales;Pseudomonadaceae;Pseudomonas
Bacteria;Proteobacteria;Gammaproteobacteria;Pseudomonadales;Pseudomonadaceae;Pseudomonas;Spumella-like_flagellate_JBAF33	Bacteria;Proteobacteria;Gammaproteobacteria;Pseudomonadales;Pseudomonadaceae;Pseudomonas
Bacteria;Proteobacteria;Gammaproteobacteria;Pseudomonadales;Pseudomonadaceae;Pseudomonas;Spumella-like_flagellate_JBC/S23	Bacteria;Proteobacteria;Gammaproteobacteria;Pseudomonadales;Pseudomonadaceae;Pseudomonas
Bacteria;Proteobacteria;Gammaproteobacteria;Pseudomonadales;Pseudomonadaceae;Pseudomonas;Spumella-like_flagellate_JBL14	Bacteria;Proteobacteria;Gammaproteobacteria;Pseudomonadales;Pseudomonadaceae;Pseudomonas
Bacteria;Proteobacteria;Gammaproteobacteria;Pseudomonadales;Pseudomonadaceae;Pseudomonas;Spumella-like_flagellate_JBM08	Bacteria;Proteobacteria;Gammaproteobacteria;Pseudomonadales;Pseudomonadaceae;Pseudomonas
Bacteria;Proteobacteria;Gammaproteobacteria;Pseudomonadales;Pseudomonadaceae;Pseudomonas;Squalius_pyrenaicus	Bacteria;Proteobacteria;Gammaproteobacteria;Pseudomonadales;Pseudomonadaceae;Pseudomonas
Bacteria;Proteobacteria;Gammaproteobacteria;Pseudomonadales;Pseudomonadaceae;Pseudomonas;Staphylococcus_arlettae	Bacteria;Proteobacteria;Gammaproteobacteria;Pseudomonadales;Pseudomonadaceae;Pseudomonas
Bacteria;Proteobacteria;Gammaproteobacteria;Pseudomonadales;Pseudomonadaceae;Pseudomonas;Stenotrophomonas_rhizophila	Bacteria;Proteobacteria;Gammaproteobacteria;Pseudomonadales;Pseudomonadaceae;Pseudomonas
Bacteria;Proteobacteria;Gammaproteobacteria;Pseudomonadales;Pseudomonadaceae;Pseudomonas;Streptomyces;	Bacteria;Proteobacteria;Gammaproteobacteria;Pseudomonadales;Pseudomonadaceae;Pseudomonas
Bacteria;Proteobacteria;Gammaproteobacteria;Pseudomonadales;Pseudomonadaceae;Pseudomonas;Streptomyces;2438	Bacteria;Proteobacteria;Gammaproteobacteria;Pseudomonadales;Pseudomonadaceae;Pseudomonas
Bacteria;Proteobacteria;Gammaproteobacteria;Pseudomonadales;Pseudomonadaceae;Pseudomonas;Sulfitobacter;GC07	Bacteria;Proteobacteria;Gammaproteobacteria;Pseudomonadales;Pseudomonadaceae;Pseudomonas
Bacteria;Proteobacteria;Gammaproteobacteria;Pseudomonadales;Pseudomonadaceae;Pseudomonas;Teleogryllus_commodus	Bacteria;Proteobacteria;Gammaproteobacteria;Pseudomonadales;Pseudomonadaceae;Pseudomonas
Bacteria;Proteobacteria;Gammaproteobacteria;Pseudomonadales;Pseudomonadaceae;Pseudomonas;Thermoleophilum_minutum	Bacteria;Proteobacteria;Gammaproteobacteria;Pseudomonadales;Pseudomonadaceae;Pseudomonas
Bacteria;Proteobacteria;Gammaproteobacteria;Pseudomonadales;Pseudomonadaceae;Pseudomonas;Triticum_aestivum_(bread_wheat)	Bacteria;Proteobacteria;Gammaproteobacteria;Pseudomonadales;Pseudomonadaceae;Pseudomonas
Bacteria;Proteobacteria;Gammaproteobacteria;Pseudomonadales;Pseudomonadaceae;Pseudomonas;Triticum_urartu	Bacteria;Proteobacteria;Gammaproteobacteria;Pseudomonadales;Pseudomonadaceae;Pseudomonas
Bacteria;Proteobacteria;Gammaproteobacteria;Salinisphaerales;Solimonadaceae;Nevskia;Persicaria_minor	Bacteria;Proteobacteria;Gammaproteobacteria;Salinisphaerales;Solimonadaceae;Nevskia
Bacteria;Proteobacteria;Gammaproteobacteria;Steroidobacterales;Steroidobacteraceae;uncultured;Hypsibius_dujardini	Bacteria;Proteobacteria;Gammaproteobacteria;Steroidobacterales;Steroidobacteraceae;
Bacteria;Proteobacteria;Gammaproteobacteria;Thiotrichales;Thiotrichaceae;Thiothrix;Talitrus_saltator	Bacteria;Proteobacteria;Gammaproteobacteria;Thiotrichales;Thiotrichaceae;Thiothrix
Bacteria;Proteobacteria;Gammaproteobacteria;Vibrionales;Vibrionaceae;Vibrio;Epeolus_variegatus	Bacteria;Proteobacteria;Gammaproteobacteria;Vibrionales;Vibrionaceae;Vibrio
Bacteria;Proteobacteria;Gammaproteobacteria;Vibrionales;Vibrionaceae;Vibrio;Glycera_dibranchiata	Bacteria;Proteobacteria;Gammaproteobacteria;Vibrionales;Vibrionaceae;Vibrio
Bacteria;Proteobacteria;Gammaproteobacteria;Vibrionales;Vibrionaceae;Vibrio;Porites_australiensis	Bacteria;Proteobacteria;Gammaproteobacteria;Vibrionales;Vibrionaceae;Vibrio
Bacteria;Proteobacteria;Gammaproteobacteria;Xanthomonadales;Xanthomonadaceae;Luteimonas;Triticum_urartu	Bacteria;Proteobacteria;Gammaproteobacteria;Xanthomonadales;Xanthomonadaceae;Luteimonas
Bacteria;Proteobacteria;Gammaproteobacteria;Xanthomonadales;Xanthomonadaceae;Luteimonas;ultramicrobacterium_str._DY01	Bacteria;Proteobacteria;Gammaproteobacteria;Xanthomonadales;Xanthomonadaceae;Luteimonas
Bacteria;Proteobacteria;Gammaproteobacteria;Xanthomonadales;Xanthomonadaceae;Stenotrophomonas;Staphylococcus_cohnii	Bacteria;Proteobacteria;Gammaproteobacteria;Xanthomonadales;Xanthomonadaceae;Stenotrophomonas
Bacteria;Spirochaetes;Spirochaetia;Brevinematales;Brevinemataceae;Brevinema;Desulfovibrio_sp._F1F22	Bacteria;Spirochaetes;Spirochaetia;Brevinematales;Brevinemataceae;Brevinema
Bacteria;Spirochaetes;Spirochaetia;Spirochaetales;Spirochaetaceae;Sediminispirochaeta;Glycera_tridactyla	Bacteria;Spirochaetes;Spirochaetia;Spirochaetales;Spirochaetaceae;Sediminispirochaeta
Bacteria;Spirochaetes;Spirochaetia;Spirochaetales;Spirochaetaceae;Spirochaeta_2;Aplysia_californica_(California_sea_hare)	Bacteria;Spirochaetes;Spirochaetia;Spirochaetales;Spirochaetaceae;Spirochaeta_2
Bacteria;Spirochaetes;Spirochaetia;Spirochaetales;Spirochaetaceae;Spirochaeta_2;Coptotermes_gestroi	Bacteria;Spirochaetes;Spirochaetia;Spirochaetales;Spirochaetaceae;Spirochaeta_2
Bacteria;Spirochaetes;Spirochaetia;Spirochaetales;Spirochaetaceae;Termite_Treponema_cluster;Coptotermes_gestroi	Bacteria;Spirochaetes;Spirochaetia;Spirochaetales;Spirochaetaceae;Termite_Treponema_cluster
Bacteria;Spirochaetes;Spirochaetia;Spirochaetales;Spirochaetaceae;Treponema;Coptotermes_gestroi	Bacteria;Spirochaetes;Spirochaetia;Spirochaetales;Spirochaetaceae;Treponema
Bacteria;Tenericutes;Mollicutes;Entomoplasmatales;Entomoplasmataceae;Entomoplasma;Monomorium_pharaonis_(pharaoh_ant)	Bacteria;Tenericutes;Mollicutes;Entomoplasmatales;Entomoplasmataceae;Entomoplasma
Bacteria;Tenericutes;Mollicutes;Entomoplasmatales;Entomoplasmatales_Incertae_Sedis;Candidatus_Hepatoplasma;Astacus_leptodactylus_(narrow-clawed_crayfish)	Bacteria;Tenericutes;Mollicutes;Entomoplasmatales;Entomoplasmatales_Incertae_Sedis;Candidatus_Hepatoplasma
Bacteria;Tenericutes;Mollicutes;Entomoplasmatales;Entomoplasmatales_Incertae_Sedis;Candidatus_Hepatoplasma;Proasellus_rectus	Bacteria;Tenericutes;Mollicutes;Entomoplasmatales;Entomoplasmatales_Incertae_Sedis;Candidatus_Hepatoplasma
Bacteria;Tenericutes;Mollicutes;Entomoplasmatales;Spiroplasmataceae;Spiroplasma;Acanthosoma_haemorrhoidale	Bacteria;Tenericutes;Mollicutes;Entomoplasmatales;Spiroplasmataceae;Spiroplasma
Bacteria;Tenericutes;Mollicutes;Entomoplasmatales;Spiroplasmataceae;Spiroplasma;Anthidium_manicatum_(wool_carder_bee)	Bacteria;Tenericutes;Mollicutes;Entomoplasmatales;Spiroplasmataceae;Spiroplasma
Bacteria;Tenericutes;Mollicutes;Entomoplasmatales;Spiroplasmataceae;Spiroplasma;Monomorium_pharaonis_(pharaoh_ant)	Bacteria;Tenericutes;Mollicutes;Entomoplasmatales;Spiroplasmataceae;Spiroplasma
Bacteria;Tenericutes;Mollicutes;Mycoplasmatales;Mycoplasmataceae;Mycoplasma;Anolis_carolinensis_(green_anole)	Bacteria;Tenericutes;Mollicutes;Mycoplasmatales;Mycoplasmataceae;Mycoplasma
Bacteria;Tenericutes;Mollicutes;Mycoplasmatales;Mycoplasmataceae;Mycoplasma;Aplysia_californica_(California_sea_hare)	Bacteria;Tenericutes;Mollicutes;Mycoplasmatales;Mycoplasmataceae;Mycoplasma
Bacteria;Tenericutes;Mollicutes;Mycoplasmatales;Mycoplasmataceae;Mycoplasma;Chlamydia_abortus	Bacteria;Tenericutes;Mollicutes;Mycoplasmatales;Mycoplasmataceae;Mycoplasma
Bacteria;Tenericutes;Mollicutes;Mycoplasmatales;Mycoplasmataceae;Mycoplasma;Chlamydia_trachomatis	Bacteria;Tenericutes;Mollicutes;Mycoplasmatales;Mycoplasmataceae;Mycoplasma
Bacteria;Tenericutes;Mollicutes;Mycoplasmatales;Mycoplasmataceae;Mycoplasma;Oncorhynchus_mykiss_(rainbow_trout)	Bacteria;Tenericutes;Mollicutes;Mycoplasmatales;Mycoplasmataceae;Mycoplasma
Bacteria;Tenericutes;Mollicutes;Mycoplasmatales;Mycoplasmataceae;Mycoplasma;Podiceps_cristatus_(great_crested_grebe)	Bacteria;Tenericutes;Mollicutes;Mycoplasmatales;Mycoplasmataceae;Mycoplasma
Bacteria;Tenericutes;Mollicutes;Mycoplasmatales;Mycoplasmataceae;Mycoplasma;Stegodyphus_tentoriicola	Bacteria;Tenericutes;Mollicutes;Mycoplasmatales;Mycoplasmataceae;Mycoplasma
	Bacteria;Verrucomicrobia;Verrucomicrobiae;Opitutales;Opitutaceae;Lacunisphaera;Hypsibius_dujardini	Bacteria;Verrucomicrobia;Verrucomicrobiae;Opitutales;Opitutaceae;Lacunisphaera
Bacteria;Verrucomicrobia;Verrucomicrobiae;Pedosphaerales;Pedosphaeraceae;Oikopleura_dioica	Bacteria;Verrucomicrobia;Verrucomicrobiae;Pedosphaerales;Pedosphaeraceae;
Bacteria;Verrucomicrobia;Verrucomicrobiae;Verrucomicrobiales;Rubritaleaceae;Luteolibacter;Oikopleura_dioica	Bacteria;Verrucomicrobia;Verrucomicrobiae;Verrucomicrobiales;Rubritaleaceae;Luteolibacter
Bacteria;Verrucomicrobia;Verrucomicrobiae;Verrucomicrobiales;Rubritaleaceae;Rubritalea;Porites_australiensis	Bacteria;Verrucomicrobia;Verrucomicrobiae;Verrucomicrobiales;Rubritaleaceae;Rubritalea
Bacteria;Verrucomicrobia;Verrucomicrobiae;Verrucomicrobiales;Verrucomicrobiaceae;Prosthecobacter;Cenchrus_americanus	Bacteria;Verrucomicrobia;Verrucomicrobiae;Verrucomicrobiales;Verrucomicrobiaceae;Prosthecobacter
Bacteria;Verrucomicrobia;Verrucomicrobiae;Verrucomicrobiales;Verrucomicrobiaceae;Prosthecobacter;Hypsibius_dujardini	Bacteria;Verrucomicrobia;Verrucomicrobiae;Verrucomicrobiales;Verrucomicrobiaceae;Prosthecobacter
Archaea;Euryarchaeota;Methanobacteria;Methanobacteriales;Methanobacteriaceae;Methanobrevibacter;Haemonchus_placei	Archaea;Euryarchaeota;Methanobacteria;Methanobacteriales;Methanobacteriaceae;Methanobrevibacter
Bacteria;Actinobacteria;Actinobacteria;Corynebacteriales;Mycobacteriaceae;Mycobacterium;Streptomyces_scabrisporus	Bacteria;Actinobacteria;Actinobacteria;Corynebacteriales;Mycobacteriaceae;Mycobacterium
Bacteria;Actinobacteria;Actinobacteria;Kineosporiales;Kineosporiaceae;Kineosporia;Actinomycetaceae	Bacteria;Actinobacteria;Actinobacteria;Kineosporiales;Kineosporiaceae;Kineosporia
Bacteria;Actinobacteria;Actinobacteria;Micrococcales;Jonesiaceae;Jonesia;Prolinoborus_fasciculus	Bacteria;Actinobacteria;Actinobacteria;Micrococcales;Jonesiaceae;Jonesia
Bacteria;Actinobacteria;Actinobacteria;Micrococcales;Microbacteriaceae;Microbacterium;Klebsiella_pneumoniae	Bacteria;Actinobacteria;Actinobacteria;Micrococcales;Microbacteriaceae;Microbacterium
Bacteria;Actinobacteria;Actinobacteria;Micrococcales;Microbacteriaceae;Microbacterium;Klebsiella_pneumoniae_subsp._pneumoniae	Bacteria;Actinobacteria;Actinobacteria;Micrococcales;Microbacteriaceae;Microbacterium
Bacteria;Firmicutes;Bacilli;Lactobacillales;Enterococcaceae;Enterococcus;Klebsiella_pneumoniae_LCT-KP289	Bacteria;Firmicutes;Bacilli;Lactobacillales;Enterococcaceae;Enterococcus
Bacteria;Proteobacteria;Alphaproteobacteria;Rhizobiales;Rhizobiaceae;Ochrobactrum;Klebsiella_sp._enrichment_culture_clone_9.2.1.1	Bacteria;Proteobacteria;Alphaproteobacteria;Rhizobiales;Rhizobiaceae;Ochrobactrum
Bacteria;Proteobacteria;Gammaproteobacteria;Alteromonadales;Idiomarinaceae;Idiomarina;Klebsiella_pneumoniae	Bacteria;Proteobacteria;Gammaproteobacteria;Alteromonadales;Idiomarinaceae;Idiomarina
	Bacteria;Proteobacteria;Gammaproteobacteria;Pseudomonadales;Moraxellaceae;Acinetobacter;Klebsiella_pneumoniae		Bacteria;Proteobacteria;Gammaproteobacteria;Pseudomonadales;Moraxellaceae;Acinetobacter
Bacteria;Proteobacteria;Gammaproteobacteria;Pseudomonadales;Pseudomonadaceae;Pseudomonas;Klebsiella_aerogenes	Bacteria;Proteobacteria;Gammaproteobacteria;Pseudomonadales;Pseudomonadaceae;Pseudomonas
Bacteria;Proteobacteria;Gammaproteobacteria;Pseudomonadales;Pseudomonadaceae;Pseudomonas;Klebsiella_aerogenes	Bacteria;Proteobacteria;Gammaproteobacteria;Pseudomonadales;Pseudomonadaceae;Pseudomonas
Bacteria;Proteobacteria;Gammaproteobacteria;Pseudomonadales;Pseudomonadaceae;Pseudomonas;Klebsiella_pneumoniae	Bacteria;Proteobacteria;Gammaproteobacteria;Pseudomonadales;Pseudomonadaceae;Pseudomonas
Bacteria;Proteobacteria;Gammaproteobacteria;Pseudomonadales;Pseudomonadaceae;Pseudomonas;Klebsiella_pneumoniae	Bacteria;Proteobacteria;Gammaproteobacteria;Pseudomonadales;Pseudomonadaceae;Pseudomonas
Bacteria;Proteobacteria;Gammaproteobacteria;Pseudomonadales;Pseudomonadaceae;Pseudomonas;Klebsiella_sp._enrichment_culture_clone_YX-2	Bacteria;Proteobacteria;Gammaproteobacteria;Pseudomonadales;Pseudomonadaceae;Pseudomonas
Bacteria;Actinobacteria;Actinobacteria;Micrococcales;Micrococcaceae;Glutamicibacter;Micrococcaceae	Bacteria;Actinobacteria;Actinobacteria;Micrococcales;Micrococcaceae;Glutamicibacter
Bacteria;Actinobacteria;Actinobacteria;Micrococcales;Micrococcaceae;Nesterenkonia;Planomicrobium_okeanokoites	Bacteria;Actinobacteria;Actinobacteria;Micrococcales;Micrococcaceae;Nesterenkonia
Bacteria;Firmicutes;Bacilli;Bacillales;Planococcaceae;Lysinibacillus;Kocuria_rhizophila	Bacteria;Firmicutes;Bacilli;Bacillales;Planococcaceae;Lysinibacillus
Bacteria;Proteobacteria;Alphaproteobacteria;Rhizobiales;Rhizobiaceae;Allorhizobium-Neorhizobium-Pararhizobium-Rhizobium;Actinokineospora_cibodasensis	Bacteria;Proteobacteria;Alphaproteobacteria;Rhizobiales;Rhizobiaceae;Allorhizobium-Neorhizobium-Pararhizobium-Rhizobium
Bacteria;Proteobacteria;Alphaproteobacteria;Rhizobiales;Rhizobiaceae;Allorhizobium-Neorhizobium-Pararhizobium-Rhizobium;Streptococcus_pneumoniae	Bacteria;Proteobacteria;Alphaproteobacteria;Rhizobiales;Rhizobiaceae;Allorhizobium-Neorhizobium-Pararhizobium-Rhizobium
Bacteria;Proteobacteria;Gammaproteobacteria;Enterobacteriales;Enterobacteriaceae;Buchnera;Dendrocerus_carpenter	Bacteria;Proteobacteria;Gammaproteobacteria;Enterobacteriales;Enterobacteriaceae;Buchnera
Bacteria;Proteobacteria;Gammaproteobacteria;Enterobacteriales;Enterobacteriaceae;Buchnera;Essigella_californica	Bacteria;Proteobacteria;Gammaproteobacteria;Enterobacteriales;Enterobacteriaceae;Buchnera
Bacteria;Proteobacteria;Gammaproteobacteria;Enterobacteriales;Enterobacteriaceae;Candidatus_Ecksteinia;Essigella_californica	Bacteria;Proteobacteria;Gammaproteobacteria;Enterobacteriales;Enterobacteriaceae;Candidatus_Ecksteinia
Bacteria;Proteobacteria;Gammaproteobacteria;Enterobacteriales;Enterobacteriaceae;Buchnera;Pemphredon_lugens	Bacteria;Proteobacteria;Gammaproteobacteria;Enterobacteriales;Enterobacteriaceae;Buchnera
Bacteria;Proteobacteria;Gammaproteobacteria;Enterobacteriales;Enterobacteriaceae;Erwinia;Quercus_robur	Bacteria;Proteobacteria;Gammaproteobacteria;Enterobacteriales;Enterobacteriaceae;Erwinia
Bacteria;Proteobacteria;Gammaproteobacteria;Enterobacteriales;Enterobacteriaceae;Escherichia-Shigella;Alexandrium_tamarense	Bacteria;Proteobacteria;Gammaproteobacteria;Enterobacteriales;Enterobacteriaceae;Escherichia-Shigella
Bacteria;Proteobacteria;Gammaproteobacteria;Enterobacteriales;Enterobacteriaceae;Escherichia-Shigella;Calanus_glacialis	Bacteria;Proteobacteria;Gammaproteobacteria;Enterobacteriales;Enterobacteriaceae;Escherichia-Shigella
Bacteria;Proteobacteria;Gammaproteobacteria;Xanthomonadales;Xanthomonadaceae;Xanthomonas;Kurthia_sibirica	Bacteria;Proteobacteria;Gammaproteobacteria;Xanthomonadales;Xanthomonadaceae;Xanthomonas
